ごるふをするおんな	ごるふをするおんな 🏌️‍♀️
英字	英字 🔠 🔡 🔤
のぶ	のぶ 🎛️
エディット	エディット ✒️
ふたつのはーと	ふたつのはーと 💕
めをとじる	めをとじる 😚
めーるじゅしんちゅう	めーるじゅしんちゅう 📨
丸いボタン	丸いボタン ⚪️ ⚫️ 🔴 🔵 🟠 🟡 🟢 🟣 🟤
下三角１	下三角１ 🔽
きっちんぺーぱー	きっちんぺーぱー 🧻
下三角２	下三角２ ⏬️
げきど	げきど 👿 😡
スマホ禁止	スマホ禁止 📵
下三角３	下三角３ 🔻
がまんするかお	がまんするかお 😣
ショーツ	ショーツ 🩳
じょしがくせい	じょしがくせい 👩‍🎓
理髪店	理髪店 💈
あかげのひと	あかげのひと 🦰
ぱらぐあい	ぱらぐあい 🇵🇾
あきれた	あきれた 🙄 🙄
ふらっぐ	ふらっぐ ⛳️ 🎌 🏁 🏳️ 🏳️‍⚧️ 🏴 🚩
!	! ‼️ ‼️ ⁉️ ⁉️ ❕️ ❕️ ❗️ ❗️
えだつの	えだつの 🫎
#	# #️⃣ #️⃣ 💢
ルーマニア	ルーマニア 🇷🇴
*	* *️⃣ *️⃣
あおいまる	あおいまる 🔵
+	+ ➕️ ➕️
牡蠣	牡蠣 🦪
男性技術者	男性技術者 👨‍💻
ちゃっく	ちゃっく 🤐
-	- ➖️ ➖️
/	/ ➗️ ➗️
グリーン	グリーン 🥗
けわしいひょうじょう	けわしいひょうじょう 🙎
北	北 ⬆️
0	0 0️⃣ 0️⃣
しゃがいひ	しゃがいひ ㊙️
1	1 1️⃣ 1️⃣
開花	開花 🌷 🌸 🌼
2	2 2️⃣ 2️⃣
ふりーだいやる	ふりーだいやる ➿️
3	3 3️⃣ 3️⃣
衛兵	衛兵 💂 💂‍♀️ 💂‍♂️
4	4 4️⃣ 4️⃣ 🍀 🍀
授乳する人	授乳する人 🧑‍🍼
5	5 5️⃣ 5️⃣ ✋️ ✋️
6	6 6️⃣ 6️⃣
7	7 7️⃣ 7️⃣
8	8 8️⃣ 8️⃣
9	9 9️⃣ 9️⃣
バーガー	バーガー 🍔
?	? ⁉️ ⁉️ ❓️ ❓️ ❔️ ❔️
せきざい	せきざい 🪨
のこぎり	のこぎり 🪚 🪚
国旗（アメリカ）	国旗（アメリカ） 🇺🇸
A	A 🅰️
かじゅある	かじゅある 👖
B	B 🅱️
嬉し泣きする猫	嬉し泣きする猫 😹
さーふぃんするひと	さーふぃんするひと 🏄️
じょせいとじょせいとおんなのことおとこのこのかぞく	じょせいとじょせいとおんなのことおとこのこのかぞく 👩‍👩‍👧‍👦
メール受信	メール受信 📩
ラバーカップ	ラバーカップ 🪠
4時30分	4時30分 🕟️
超人	超人 🦸 🦸‍♀️ 🦸‍♂️ 🦹‍♀️ 🦹‍♂️
なっつ	なっつ 🥜
M	M Ⓜ️ Ⓜ️
だんせいかいしゃいん	だんせいかいしゃいん 👨‍💼
うわむきにすぼめたて	うわむきにすぼめたて 🤌
O	O 🅾️
南	南 ⬇️
P	P 🅿️
なっと	なっと 🔩
時計（４時）	時計（４時） 🕓️
持ち帰り	持ち帰り 🥡
ヤマアラシ	ヤマアラシ 🦔
バドミントン	バドミントン 🏸
べんとうばこ	べんとうばこ 🍱
カーレース	カーレース 🏎️
らぶれたー	らぶれたー 💌
らくだ	らくだ 🐪 🐫 🐫
手を返している人	手を返している人 💁
ばんそうこう	ばんそうこう 🩹 🩹
高輝度	高輝度 🔆
セルビア	セルビア 🇷🇸
めのらー	めのらー 🕎
a	a 🅰️
b	b 🅱️
むしんろん	むしんろん ⚛️
i	i ℹ️ ℹ️
宇宙飛行士	宇宙飛行士 👨‍🚀 👩‍🚀 🧑‍🚀
ぜんもんせいかい	ぜんもんせいかい 💯
あきまーく	あきまーく 🈳
えでぃっと	えでぃっと ✒️
卵	卵 🍳 🐣 🥚 🪺
じょせいとだんせいのかっぷる	じょせいとだんせいのかっぷる 👩‍❤️‍👨
o	o 🅾️
p	p 🅿️
たまき	たまき 🔗
A型	A型 🅰️
すいみんぐ	すいみんぐ 🏊️ 🏊‍♀️ 🏊‍♂️
首を縦に振る	首を縦に振る 🙂‍↕️
たまご	たまご 🍳 🐣 🥚 🪺
おもちゃ	おもちゃ 🧸 🧸 🪀 🪀 🪁 🪁 🪃
魚を食べる	魚を食べる 🦦
ナザール	ナザール 🧿
不機嫌な猫	不機嫌な猫 😾
はーどとう	はーどとう 🇭🇲
ハート（青）	ハート（青） 💙
しゃぼんだま	しゃぼんだま 🫧
すてーき	すてーき 🥩
おとなひとりとこどもふたりのかぞく	おとなひとりとこどもふたりのかぞく 🧑‍🧒‍🧒
女性と女の子と女の子の家族	女性と女の子と女の子の家族 👩‍👧‍👧
パレスチナ自治区	パレスチナ自治区 🇵🇸
お祭り	お祭り 🎆 🎇
すうじのにゅうりょく	すうじのにゅうりょく 🔢
たいわん	たいわん 🇹🇼
だんせいとだんせいとおとこのこのかぞく	だんせいとだんせいとおとこのこのかぞく 👨‍👨‍👦
羽毛	羽毛 🪶
たまる	たまる 🫔
こわれた	こわれた ⛓️‍💥
さくら	さくら 🌸 🌸
左矢印	左矢印 ⬅️
フェロー諸島	フェロー諸島 🇫🇴
悪人	悪人 🦹
でんしゃ	でんしゃ 🚃 🚄 🚅 🚆 🚇️ 🚈 🚉 🚊 🚋 🚝 🚞 🚟
ビールで乾杯	ビールで乾杯 🍻
吸収	吸収 🧽
高速道路	高速道路 🛣️
和服	和服 👘
あみゅーずめんとぱーく	あみゅーずめんとぱーく 🎡 🎢
口	口 👄 🤐 🫦
あくい	あくい 🖤
えんぴつ	えんぴつ ✏️ 📝
車椅子マーク	車椅子マーク ♿️
いやし	いやし 💆
乳牛	乳牛 🐄
合	合 🈴
蒸気機関車	蒸気機関車 🚂
たくはいびん	たくはいびん 📦️
はいきんぐしゅーず	はいきんぐしゅーず 🥾
可	可 🉑
ひょうしょう	ひょうしょう 🎖️ 🏅 🏆️
紅包	紅包 🧧
ちょうかく	ちょうかく 🦻 🧏 🧏‍♀️ 🧏‍♂️
フォークランド諸島	フォークランド諸島 🇫🇰
稲妻	稲妻 ⚡️ ⛈️ 🌩️
右	右 ↪️ ➡️ 👉️ 🤜
すぽんじ	すぽんじ 🧽
くっくしょとう	くっくしょとう 🇨🇰
くろいとり	くろいとり 🐦‍⬛
おなか	おなか 🫄
両目	両目 👀
とろぴかる	とろぴかる 🍋‍🟩 🍍 🍹 🥭
どっとつきひしがた	どっとつきひしがた 💠
へっどほん	へっどほん 🎧️
ちょうきょりそう	ちょうきょりそう 🎽
べーるのじょせい	べーるのじょせい 👰‍♀️
ちぇーん	ちぇーん ⛓️ ⛓️‍💥
ひたいにてをあてるひと	ひたいにてをあてるひと 🤦
顔３（かなしいカオ）	顔３（かなしいカオ） 😭
取り出し	取り出し ⏏️
だんせいかがくしゃ	だんせいかがくしゃ 👨‍🔬
ヴィエス	ヴィエス 🆚
くーる	くーる 🆒 😎
がまん	がまん 😣
みぎむきのこぶし	みぎむきのこぶし 🤜
おおきいまる	おおきいまる 🔴 🔵
にく	にく 🍖 🍗 🥓 🥩
疲れた顔	疲れた顔 😫
あせあせ（飛び散る汗）	あせあせ（飛び散る汗） 💦
にし	にし ⬅️
にじ	にじ 🌈 🕑️
白四角大	白四角大 ◻️
女性宇宙飛行士	女性宇宙飛行士 👩‍🚀
ロッククライマー	ロッククライマー 🧗
アンドラ	アンドラ 🇦🇩
はんまーとれんち	はんまーとれんち 🛠️
じてんしゃにのるじん	じてんしゃにのるじん 🚴
あくま	あくま 👿 😈
ぐーぐー	ぐーぐー 💤 😴 🛌
ビタミンＣ	ビタミンＣ 🍊
キリン	キリン 🦒
オットセイ	オットセイ 🦭
美容院	美容院 ✂️ 💇 💇‍♀️ 💇‍♂️ 💈
ミルクティー	ミルクティー 🧋
シリアル	シリアル 🥣
りびあ	りびあ 🇱🇾
山から日の出	山から日の出 🌄
緑ハート	緑ハート 💚
スニーカー	スニーカー 👟
にやりとする猫	にやりとする猫 😼
和	和 🎋 🎍 🎎
がいあな	がいあな 🇬🇾
うそでしょ	うそでしょ 🤦 🤦 🤦‍♀️ 🤦‍♀️ 🤦‍♂️ 🤦‍♂️
にわ	にわ 🏡
たこあげ	たこあげ 🪁
牛の顔	牛の顔 🐮
ふんすい	ふんすい ⛲️
おいしそう	おいしそう 😋 😋
たいこ	たいこ 🥁 🪘
メール受信中	メール受信中 📨
わかれた	わかれた 💔
ネット	ネット 🥅
みぎうえやじるし	みぎうえやじるし ↗️
みんぞくいしょう	みんぞくいしょう 🥻
ゴムぞうり	ゴムぞうり 🩴
まんりき	まんりき 🗜️
かしゅ	かしゅ 👨‍🎤 👩‍🎤 🧑‍🎤
ＵＰ	ＵＰ 🆙
たいむ	たいむ ⏱️
サービス料	サービス料 🈂️
はつかねずみ	はつかねずみ 🐁
ウェディング	ウェディング 👰
れっどきどにー	れっどきどにー 🫘
ひな人形	ひな人形 🎎
こうしゃ	こうしゃ 🏫
そつぎょうしき	そつぎょうしき 🎓️
たいや	たいや 🛞
ばっくぱっく	ばっくぱっく 🎒 🥾
バッド（下向き矢印）	バッド（下向き矢印） ⤵️
おひめさま	おひめさま 👸
あきらめ	あきらめ 😩 😩 😮‍💨 😮‍💨
パーティークラッカー	パーティークラッカー 🎉
雪雲	雪雲 🌨️
重量挙げをする男	重量挙げをする男 🏋️‍♂️
えむでぃー	えむでぃー 💽
じょせいとじょせいとおとこのこのかぞく	じょせいとじょせいとおとこのこのかぞく 👩‍👩‍👦
聞く	聞く 👂️
電話１（プッシュホン）	電話１（プッシュホン） ☎️
ドーナツ	ドーナツ 🍩
じょせいしょうぼうし	じょせいしょうぼうし 👩‍🚒
こうしん	こうしん 🆙 🔄
タクシー	タクシー 🚕 🚖 🛺
あおいほん	あおいほん 📘
がっかり	がっかり 😔 😔 😞 😞
しぇいぶあいす	しぇいぶあいす 🍧
だんせいとだんせいとおんなのこのかぞく	だんせいとだんせいとおんなのこのかぞく 👨‍👨‍👧
ラオス	ラオス 🇱🇦
唇	唇 👄 💋 🫦
ロマンス	ロマンス 💒
とめがね	とめがね 🪝
レスリングする人	レスリングする人 🤼
手荷物受取	手荷物受取 🛄
予定	予定 📅 📆 🗓️
スキーヤー	スキーヤー ⛷️
まきげ	まきげ 👨‍🦱 👩‍🦱 🦱 🧑‍🦱
ぼーるぺん	ぼーるぺん 🖊️
おとなふたりとこどもひとりのかぞく	おとなふたりとこどもひとりのかぞく 🧑‍🧑‍🧒
たーくすかいこすしょとう	たーくすかいこすしょとう 🇹🇨
すぴーかーしょうおん	すぴーかーしょうおん 🔇
じゅうりょうあげをするおとこ	じゅうりょうあげをするおとこ 🏋️‍♂️
しゅちょう	しゅちょう 🪧
とりすたんだくーにゃ	とりすたんだくーにゃ 🇹🇦
ぺーぱーたおる	ぺーぱーたおる 🧻
TMまーく	TMまーく ™️
八分音符	八分音符 🎵
てぃーしゃつ	てぃーしゃつ 👕
トラックボール	トラックボール 🖲️
火花	火花 🎇 🧨
パイロット	パイロット 👨‍✈️ 🧑‍✈️
あふろこーむ	あふろこーむ 🪮
黒四角特大	黒四角特大 ⬛️
家畜	家畜 🐄 🐎 🐐 🐑 🐖
球技	球技 ⛹️ ⛹️‍♀️ ⛹️‍♂️ 🏌️ 🏌️‍♀️ 🤽 🤽‍♀️ 🤽‍♂️ 🤾 🤾‍♀️ 🤾‍♂️
しょうこうき	しょうこうき 🛗
ウズベキスタン	ウズベキスタン 🇺🇿
杖をついた女性	杖をついた女性 👩‍🦯 👩‍🦯‍➡️
うるうる	うるうる 🥹 🥹
キルギス	キルギス 🇰🇬
cool	cool 🆒
ドラゴンの顔	ドラゴンの顔 🐲
あらーむ	あらーむ ⏰️
カードインデックス	カードインデックス 📇
お城（西洋）	お城（西洋） 🏰
とまどい	とまどい 😳 😳
湯気	湯気 ♨️
善	善 🦸 🦸‍♀️ 🦸‍♂️
れきし	れきし 🏛️
のうぎょう	のうぎょう 🧑‍🌾
おわんぼう	おわんぼう 👲
せいちょう	せいちょう 📈
しゅうかく	しゅうかく 🧺
へとへと	へとへと 😩 😩
グレー	グレー 🦳 🩶
悪意	悪意 🖤
手を挙げる人	手を挙げる人 🙋
作業員	作業員 👷 👷‍♀️ 👷‍♂️ 🧑‍🔧
あんないするおんな	あんないするおんな 💁 💁‍♀️
ヤギ	ヤギ 🐐
こわい	こわい 👹 👻 😨
モルドバ	モルドバ 🇲🇩
青い顔	青い顔 😰 🥶
ヤシ	ヤシ 🌴 🏝️
封筒	封筒 ✉️ 💌 📧 📨
ホットドッグ	ホットドッグ 🌭
オフィスビル	オフィスビル 🏢
れすりんぐ	れすりんぐ 🤼 🤼‍♀️ 🤼‍♂️
月見	月見 🎑
バイク	バイク 🏍️ 🛵
しょっぴんぐ	しょっぴんぐ 👜 🛒
NEW	NEW 🆕
不機嫌な男	不機嫌な男 🙎‍♂️
メールする	メールする 📩
ホルスタイン	ホルスタイン 🐮
営	営 🈺
バイス	バイス 🗜️
表情（がっかり）	表情（がっかり） 😞
画びょう	画びょう 📍
よぼうせっしゅ	よぼうせっしゅ 💉
ていくあうとべんとう	ていくあうとべんとう 🥡
ぷー（かわいく怒）	ぷー（かわいく怒） 😡
ウィスキー	ウィスキー 🥃
ろくおん	ろくおん ⏺️
さびしい	さびしい 😢
右肩下がり	右肩下がり 📉
じゅにゅうするだんせい	じゅにゅうするだんせい 👨‍🍼
さんとめぷりんしぺ	さんとめぷりんしぺ 🇸🇹
にこにこ	にこにこ 😊 😊 😋
ふつりょうぽりねしあ	ふつりょうぽりねしあ 🇵🇫
アンテナ	アンテナ 📡
こわれたくさり	こわれたくさり ⛓️‍💥
このは	このは 🍂 🍃
じょせいとじょせいとおんなのこのかぞく	じょせいとじょせいとおんなのこのかぞく 👩‍👩‍👧
マラカス	マラカス 🪇
とうひょうばこ	とうひょうばこ 🗳️
チェックマーク	チェックマーク ☑️ ✅️ ✔️
とう	とう 🗼
スカーフの女性	スカーフの女性 🧕
引き算	引き算 ➖️
凶器	凶器 🔪
表情（ラブラブ）	表情（ラブラブ） 😍
かんがえちゅう	かんがえちゅう 🤔
営業中マーク	営業中マーク 🈺
しょうせつ	しょうせつ 📖 📚️
女性パイロット	女性パイロット 👩‍✈️
赤い封筒	赤い封筒 🧧
ストーン	ストーン 🥌
嘘	嘘 🤥
めとろ	めとろ 🚇️
次の曲ボタン	次の曲ボタン ⏭️
とく	とく 🉐
男の精霊	男の精霊 🧞‍♂️
とげ	とげ 🦔 🦔
ラケット	ラケット 🎾 🏓 🏸
飲用不可	飲用不可 🚱
とし	とし 🌆 🏙️
上	上 ⏫️ ☝️ ⤴️ ⬆️ 👆️ 👍️ 🔝 🔺 🔼 🖕 🫴
らむ	らむ 🥩
下	下 ⏬️ ⤵️ ⬇️ 👇️ 👎️ 🔻 🔽 🫳
おでん	おでん 🍢 🍢
待て	待て 🫷 🫸
くりっぱーとんとう	くりっぱーとんとう 🇨🇵
ばっく	ばっく 🔙
ばっぐ	ばっぐ 👜 👝 🛍️
領収書	領収書 🧾
とら	とら 🐅 🐯
かえるのかお	かえるのかお 🐸
とど	とど 🦭
とり	とり 🐓 🐔 🐣 🐤 🐥 🐦️ 🐦‍⬛ 🐧 🕊️ 🦃 🦅 🦆 🦉 🦚 🦜 🦢 🦤 🦩 🪶 🪽 🪿
フィッシング	フィッシング 🎣 🐟️
さいくつ	さいくつ ⛏️
とっくり（おちょこ付き）	とっくり（おちょこ付き） 🍶
けつえきがたびーがた	けつえきがたびーがた 🅱️
ばっじ	ばっじ 📛
らば	らば 🫏
うれしい顔	うれしい顔 😆
マイタイ	マイタイ 🍹
がくせい	がくせい 👨‍🎓 👩‍🎓 🧑‍🎓
とぶ	とぶ 🪶 🪽
ばった	ばった 🦗
らぶ	らぶ 💕 😍 🥰 🩵 🩶 🩷 🫶
ちいさいあおのひしがた	ちいさいあおのひしがた 🔹
姿見	姿見 🪞
ぜぶら	ぜぶら 🦓
ライオンの顔	ライオンの顔 🦁
紳士服	紳士服 👕
いい気分（温泉）	いい気分（温泉） ♨️
そらいろ	そらいろ 🩵
きゃっち	きゃっち 🤾 🤾‍♀️
らぼ	らぼ 🧪
ぎゃんぶる	ぎゃんぶる 🎰
海獣	海獣 🦭
らま	らま 🦙
ばっと	ばっと 🏏
ばっど	ばっど ⤵️
泳ぐ人	泳ぐ人 🏊️
中	中 🀄️
じゅもく	じゅもく 🪵
寒い	寒い 😰 🧣 🧥
串	串 🍡 🍢
しいたけ	しいたけ 🍄‍🟫 🍄‍🟫
すなはま	すなはま ⛱️ 🏖️
ほーむ	ほーむ 🏡
玉ねぎ	玉ねぎ 🧅
不機嫌	不機嫌 😾 🙎 🙎‍♀️ 🙎‍♂️
丸	丸 ⏺️ Ⓜ️ ⚪️ ⚫️ 🔴 🔵 🙆 🙆‍♀️ 🙆‍♂️ 🟠 🟡 🟢 🟣 🟤
わからん	わからん 😖
ふあん	ふあん 😨
きゃっぷ	きゃっぷ 🧢
はいたっち	はいたっち 🙏 🫷 🫸
亀	亀 🐢
ダイビング	ダイビング 🤿 🥽 🦪
たきしーどのひと	たきしーどのひと 🤵
ほーる	ほーる ⛳️
寒さ	寒さ 🥶
人のシルエット	人のシルエット 👤
農業	農業 🧑‍🌾
音無し	音無し 🔇 🔕
南西	南西 ↙️
こんせんと	こんせんと 🔌
COOL!	COOL! 🆒
じゅもん	じゅもん 🧙
石材	石材 🪨
ufo	ufo 🛸
限界	限界 😫
クール	クール 🆒 😎
とーく	とーく 💬
ロボットの顔	ロボットの顔 🤖
まんてん	まんてん 💯
椅子	椅子 💺 🦼 🦽 🪑
おとこのきゅうけつき	おとこのきゅうけつき 🧛‍♂️
とーご	とーご 🇹🇬
さむずあっぷ	さむずあっぷ 👍️
そくてんするおとこ	そくてんするおとこ 🤸‍♂️
花粉症	花粉症 😷 🤧
笑った悪魔	笑った悪魔 😈
ラトル	ラトル 🪇
電波状況	電波状況 📶
ノート２（開）	ノート２（開） 📖
ハリウッド	ハリウッド 🎥
ゆうがいぶっしつ	ゆうがいぶっしつ ☣️
パラオ	パラオ 🇵🇼
赤い丸	赤い丸 ⭕️ 🔴
名札	名札 📛
はたつきぽすと	はたつきぽすと 📪️ 📫️
惑星	惑星 🪐
やや欠け月	やや欠け月 🌔
癒し	癒し 💆
イギリス	イギリス 🇬🇧
困惑した顔	困惑した顔 😖
グラフ	グラフ 💹 📈 📊
はくじゅうじ	はくじゅうじ ⛑️
ぴーすまーく	ぴーすまーく ☮️
カウガール	カウガール 🤠
トレードマーク	トレードマーク ™️
入場券	入場券 🎟️ 🎫
眠い（ＺＺＺ…）	眠い（ＺＺＺ…） 💤
極秘	極秘 ㊙️
グラス	グラス 🍷 🍸️ 🥂 🥃 🥛
進入禁止	進入禁止 ⛔️
人	人 👨‍🍼 👩‍🍼 👰 👱 🙅 🙆 🙋 🚶 🚶‍➡️ 🤦 🤵 🤷 🥷 🦹 🧍 🧎 🧎‍➡️ 🧏 🧑‍🍼 🧑‍🎄 🧑‍🤝‍🧑 🧔
クラウン	クラウン 👑
におい	におい 🧄 🧄
くびをよこにふる	くびをよこにふる 🙂‍↔️
レスリングをする	レスリングをする 🤼‍♀️ 🤼‍♂️
白四角小	白四角小 ▫️
こいぬのめ	こいぬのめ 🥺
ふあー	ふあー 🥱
握手	握手 🤝 🫱 🫲
サボテン	サボテン 🌵 🏜️
てにす	てにす 🎾
民族衣装	民族衣装 🥻
浴槽	浴槽 🛀 🛁
ふぁんたじー	ふぁんたじー 🐦‍🔥 🧌 🧙 🧚 🧝 🧞
自転車乗り	自転車乗り 🚴 🚴‍♀️ 🚵 🚵‍♀️
でざーと	でざーと 🍡 🍦 🍧 🍨 🍩 🍪 🍫 🍮 🍰
お弁当	お弁当 🍱
ぱえりあなべ	ぱえりあなべ 🥘
子ども	子ども 🧒
ちゃいろいしかく	ちゃいろいしかく 🟫
リゾート	リゾート ⛵️
山羊座	山羊座 ♑️
レスリングする女	レスリングする女 🤼‍♀️
グラフ２	グラフ２ 📉
かっぷる	かっぷる 👨‍❤️‍👨 👨‍❤️‍💋‍👨 👩‍❤️‍👨 👩‍❤️‍👩 👩‍❤️‍💋‍👨 👩‍❤️‍💋‍👩 👫 👬 👭 💏 💑 🧑‍🤝‍🧑
しろしかくだい	しろしかくだい ◻️
へいし	へいし 🪖
ふぇろーしょとう	ふぇろーしょとう 🇫🇴
スーツケース	スーツケース 🛄 🛅 🧳
技術者	技術者 🧑‍💻
てれび	てれび 📺️
みぎがわ	みぎがわ 🫱
コンピュータ	コンピュータ 👨‍💻 👩‍💻 🧑‍💻
セラピスト	セラピスト 👨‍⚕️ 👩‍⚕️ 🧑‍⚕️
もばいる	もばいる 📱 📲
ごみすて	ごみすて 🚮
男性警察官	男性警察官 👮‍♂️
パトカー正面	パトカー正面 🚔️
いそぐ	いそぐ 🏃 🏃‍♀️ 🏃‍♀️‍➡️ 🏃‍➡️ 💨
いそげ	いそげ 💨
放る	放る 🤾 🤾‍♀️
返って来る	返って来る 🪃
ラベンダー	ラベンダー 🪻
ばすたぶ	ばすたぶ 🛀 🛁
アメリカ	アメリカ 🌎️ 🗽
メモ	メモ 📋️ 📝
バルカン人	バルカン人 🖖
すとらでぃばりうす	すとらでぃばりうす 🎻
へいわ	へいわ ☮️ 🕊️ 😇
かどまつ	かどまつ 🎍
ミルキーウェイ	ミルキーウェイ 🌌
coolまーく	coolまーく 🆒
ここなっつ	ここなっつ 🥥
たいたにっくごう	たいたにっくごう 🚢
携帯電話電源オフ	携帯電話電源オフ 📴
あーと	あーと 🎨 🖼️
キッチンペーパー	キッチンペーパー 🧻
ねむい	ねむい 😪 😴 🥱 🫩
城	城 🏯 🏰
ふりかけようき	ふりかけようき 🧂
おーけー	おーけー 🆗 👌 👍️ 🙆 🙆‍♀️ 🙆‍♂️ 🫡
パラグアイ	パラグアイ 🇵🇾
ゆう	ゆう 🈶
ピーナッツ	ピーナッツ 🥜
えいがかめら	えいがかめら 🎥
競輪	競輪 🚴 🚴‍♀️ 🚴‍♂️
おっはー	おっはー 👐 👐
ぴーなっつ	ぴーなっつ 🥜
ジャグリングをする男	ジャグリングをする男 🤹‍♂️
しょうじょ	しょうじょ 👧
ゆき	ゆき ☃️ ⛄️ ❄️ 🌨️ 🎿 🏔️
ネクタイ	ネクタイ 👔
しょるい	しょるい 📃 📄 📜
マル秘	マル秘 ㊙️
ほじょけん	ほじょけん 🦮
ゆげ	ゆげ ♨️
ラグビー	ラグビー 🏉
新月	新月 🌑 🌚
手を挙げる女	手を挙げる女 🙋‍♀️
スケジュール	スケジュール 📅 📆 🗓️
しごせん	しごせん 🌐
ばーばー	ばーばー 💈
バス停	バス停 🚏
ねむる	ねむる 😪 😴
はしるひと	はしるひと 🏃 🏃‍➡️
せいようのしろ	せいようのしろ 🏰
カップケーキ	カップケーキ 🧁
ゆり	ゆり ⚜️
ごーるど	ごーるど 🥇
しょくだい	しょくだい 🕎
絵画	絵画 🎨 🖼️
緑の本	緑の本 📗
右回り縦矢印	右回り縦矢印 🔃
とりにだーどとばご	とりにだーどとばご 🇹🇹
うんこ	うんこ 💩 💩
のーとぱそこん	のーとぱそこん 💻️
ウェイトリフティング	ウェイトリフティング 🏋️ 🏋️‍♀️ 🏋️‍♂️
火薬	火薬 🧨
ゆび	ゆび ✌️ 🈯️ 👆️ 👇️ 👈️ 👉️ 🖕 🤌 🤏 🤞 🫰 🫵
カバン	カバン 👜
プレイ	プレイ ▶️
壊れた鎖	壊れた鎖 ⛓️‍💥
トマト	トマト 🍅
はやもどしぼたん	はやもどしぼたん ⏪️
うんち	うんち 💩 💩
工場・建物	工場・建物 🏢
塔	塔 🗼
ゆみ	ゆみ 🏹
わがし	わがし 🍡
アルコール	アルコール 🍷 🍸️ 🍹 🍺 🍻
ＯＫ	ＯＫ 🆗 👌 🙆
もりのひと	もりのひと 🦧
ばすけっとぼーるをするおんな	ばすけっとぼーるをするおんな ⛹️‍♀️
ニューカレドニア	ニューカレドニア 🇳🇨
オオカミの顔	オオカミの顔 🐺
キリスト教	キリスト教 ☦️ ⛪️ ✝️
ほうき	ほうき 🧹 🧹
あんぜんぴん	あんぜんぴん 🧷
森の人	森の人 🦧
ごらいこう	ごらいこう 🌄
かける	かける ✖️ ✖️
まふらー	まふらー 🧣
ボケーっとした顔	ボケーっとした顔 😒
ライト	ライト 🔦
塩	塩 🧂
りゅーじゅ	りゅーじゅ 🛷
にじゅうよじかんえいぎょう	にじゅうよじかんえいぎょう 🏪
悪	悪 🦹 🦹‍♀️ 🦹‍♂️
むらさきのしかく	むらさきのしかく 🟪
かんかん	かんかん 👿 👿 😡 😡
へたなげ	へたなげ 🥎
ドル記号	ドル記号 💲
ぐれーぷ	ぐれーぷ 🍇
えるさるばどる	えるさるばどる 🇸🇻
ライス	ライス 🍚 🍛
全問正解	全問正解 💯
壁	壁 🧱
ナイジェリア	ナイジェリア 🇳🇬
ライム	ライム 🍋‍🟩
定規１	定規１ 📏
パワーリフティング	パワーリフティング 🏋️
定規２	定規２ 📐
すまーとふぉんきんし	すまーとふぉんきんし 📵
バゲット	バゲット 🥖
情報	情報 ℹ️
彗星	彗星 ☄️
かけづき	かけづき 🌔
くりっぷ	くりっぷ 📋️ 📎 🖇️
だんせいのようせつこう	だんせいのようせつこう 👨‍🏭
ひたいに手	ひたいに手 🤦 🤦‍♀️ 🤦‍♂️
いもむし	いもむし 🐛
プッシュピン（画鋲）	プッシュピン（画鋲） 📍
ホイール	ホイール 🛞
バゲッジクレーム	バゲッジクレーム 🛄
愛	愛 ❤️ ❤️‍🔥 💛 💜 🩵 🩶 🩷 🪉 🫰 🫶
内緒	内緒 🙊 🤐 🤭
国旗（ロシア）	国旗（ロシア） 🇷🇺
八角星	八角星 ✴️
指差し（左）	指差し（左） 👈️
どうせい	どうせい 👬 👭
七夕	七夕 🎋
泳ぐ女	泳ぐ女 🏊‍♀️
えがお	えがお ☺️ 😀 😁 😂 😃 😄 😅 😆 😇 😈 😊 😋 😍 😎 😙 😸 😹 😺 😻 🙂 🙃 🤗 🤣 🤩 🤭 🥰 🥳
下に向けた手	下に向けた手 🫳
星座（やぎ座）	星座（やぎ座） ♑️
ふたこぶ	ふたこぶ 🐫
しずく	しずく 💦 💦 💧 💧
あくびしたかお	あくびしたかお 🥱
青りんご	青りんご 🍏
充電不足	充電不足 🪫
ベリーズ	ベリーズ 🇧🇿
夏	夏 🎐 🪭
れべるすらいだー	れべるすらいだー 🎚️
プライド	プライド 🏳️‍🌈
口が斜めの顔	口が斜めの顔 🫤
開ける	開ける 🪟
そうしょくきょうりゅう	そうしょくきょうりゅう 🦕
毛糸	毛糸 🧶
夜空	夜空 🌌
うぇでぃんぐ	うぇでぃんぐ 👰
壺	壺 🍯 🏺
きゅうめいぐ	きゅうめいぐ 🛟
夜	夜 🌃 🌉 🌠
アセンション島	アセンション島 🇦🇨
一時停止	一時停止 ⏯️ ⏸️
2つのハート	2つのハート 💕
えじぷと	えじぷと 🇪🇬
しゃっふるぼたん	しゃっふるぼたん 🔀
ひきつける	ひきつける 🧲
サイン	サイン 🚧
相方	相方 👯
にゅうりょく	にゅうりょく 🔠 🔡 🔢 🔣 🔤
2時半	2時半 🕝️
あやつる	あやつる 🤹 🤹‍♂️
引き付ける	引き付ける 🧲
いんふぉめーしょん	いんふぉめーしょん ℹ️
しろいかんたんふ	しろいかんたんふ ❕️
ひだりむきさんかく	ひだりむきさんかく ◀️
こわれたはーと	こわれたはーと 💔
裁縫	裁縫 🧵 🪡
アイス	アイス 🍦 🍧 🍨
さうな	さうな 🧖 🧖‍♀️ 🧖‍♂️
オタク	オタク 🤓
しゃべる	しゃべる 🦜 🦜 🪏
きゅうじょ	きゅうじょ 🛟
カジュアル	カジュアル 👖
ママ	ママ 👩‍🍼
けつえきがたえいびーがた	けつえきがたえいびーがた 🆎
失望した顔	失望した顔 😞
びょういん	びょういん 🏥
盲導犬	盲導犬 🦮
割マーク	割マーク 🈹
ひのついた	ひのついた ❤️‍🔥
しょうさい	しょうさい 🔎
COOL	COOL 🆒
マリ	マリ 🇲🇱
乗馬	乗馬 🏇 🐎
三つ又	三つ又 🔱
百貨店	百貨店 🏬
一時停止ボタン	一時停止ボタン ⏸️
女	女 ♀️ 🏄‍♀️ 🏊‍♀️ 🏋️‍♀️ 🏌️‍♀️ 👧 👩 👩‍⚕️ 👩‍⚖️ 👩‍✈️ 👩‍🌾 👩‍🍳 👩‍🍼 👩‍🎓 👩‍🎤 👩‍🎨 👩‍🏫 👩‍🏭 👩‍💻 👩‍💼 👩‍🔧 👩‍🔬 👩‍🚀 👩‍🚒 👩‍🦰 👩‍🦱 👩‍🦲 👩‍🦳 👫 👭 👯‍♀️ 👰‍♀️ 👱‍♀️ 👳‍♀️ 👷‍♀️ 👸 💁‍♀️ 💃 💆‍♀️ 🕵️‍♀️ 🙅‍♀️ 🙇‍♀️ 🙋‍♀️ 🙍‍♀️ 🙎‍♀️ 🚣‍♀️ 🚴‍♀️ 🚵‍♀️ 🤦‍♀️ 🤰 🤱 🤵‍♀️ 🤶 🤷‍♀️ 🤹‍♀️ 🧔‍♀️ 🧕 🧖‍♀️ 🧗‍♀️ 🧘‍♀️ 🧙‍♀️ 🧚‍♀️ 🧛‍♀️ 🧜‍♀️ 🧝‍♀️ 🧞‍♀️ 🧟‍♀️
イエメン	イエメン 🇾🇪
クリスマスツリー	クリスマスツリー 🎄
ていてつ	ていてつ 🧲
飾り２	飾り２ ✴️
ブーツ	ブーツ 👢 🥾
飾り３	飾り３ ✳️
開発者	開発者 👨‍💻 👩‍💻 🧑‍💻
守衛	守衛 💂 💂‍♀️ 💂‍♂️
ろっかくせい	ろっかくせい 🔯
しーえる	しーえる 🆑
トランプ	トランプ ♠️ ♣️ ♥️ ♦️ 🃏
ヒマワリ	ヒマワリ 🌻
ひらいたほん	ひらいたほん 📖
まとりょーしか	まとりょーしか 🪆
ぶんしょ	ぶんしょ 📃 📄 📜
するどい	するどい 🪒
ブーケ	ブーケ 💐
おちゃ	おちゃ 🍵 🧉 🧋 🫖
温かい飲み物	温かい飲み物 ☕️
ひょうざん	ひょうざん 🧊
天文学	天文学 ⭐️
でんわはっしん	でんわはっしん 📲
エンドウ豆	エンドウ豆 🫛
わーい	わーい 😃 😃 😄 😄 😅 😝 😝 🤩 🤩
おちば	おちば 🍁 🍂 🍃
ぼると	ぼると 🔩
びーるじょっき	びーるじょっき 🍺
着物	着物 👘
不死身	不死身 🧛
しまうま	しまうま 🦓
扇	扇 🪭
星座（うお座）	星座（うお座） ♓️
未確認飛行物体	未確認飛行物体 🛸
かなりあしょとう	かなりあしょとう 🇮🇨
スティック	スティック 🏑 🏒 🕹️ 🥍
扉	扉 🚪
だんせいとじょせいとおとこのこのかぞく	だんせいとじょせいとおとこのこのかぞく 👨‍👩‍👦
女性と女性と男の子と男の子の家族	女性と女性と男の子と男の子の家族 👩‍👩‍👦‍👦
手	手 ☝️ ✊️ ✋️ ✌️ ✍️ 👆️ 👇️ 👈️ 👉️ 👊 👋 👌 👍️ 👎️ 👏 👐 🖐️ 🖕 🖖 🙆 🙋 🙌 🙏 🤌 🤏 🤘 🤙 🤚 🤛 🤜 🤝 🤞 🤟 🤲 🦾 🧑‍🤝‍🧑 🧤 🪬 🫰 🫱 🫲 🫳 🫴 🫵 🫶 🫷 🫸
じょせいとおとこのことおとこのこのかぞく	じょせいとおとこのことおとこのこのかぞく 👩‍👦‍👦
疲れ	疲れ 😩 😫 🥱
ちゅうどく	ちゅうどく 🥴
のうじょうぬし	のうじょうぬし 🧑‍🌾
すーつけーす	すーつけーす 🛄 🛅 🧳
てんびんざ	てんびんざ ♎️ ⚖️
はんしゃ	はんしゃ 🦺 🪞
アート	アート 🎨 🖼️
娘	娘 👧
戸	戸 🚪
ヨガのポーズをする男	ヨガのポーズをする男 🧘‍♂️
れすきゅー	れすきゅー 🛟 🧑‍🚒
ハチミツ	ハチミツ 🍯
ぱすわーど	ぱすわーど 🔑 🗝️
ぱすぽーとこんとろーる	ぱすぽーとこんとろーる 🛂
厚着	厚着 🧣 🧥
考えてる顔	考えてる顔 😔
ぺたんこ靴	ぺたんこ靴 🥿
けつえきがたえいがた	けつえきがたえいがた 🅰️
ちゃくしんちゅう	ちゃくしんちゅう 📲
前を向いているひよこ	前を向いているひよこ 🐥
競馬	競馬 🏇 🐎
のーと	のーと 📒 📓 📔 🗒️
げきじょう	げきじょう 🎭️
プラグ	プラグ 🔌
あーるまーく	あーるまーく ®️
ぼるととなっと	ぼるととなっと 🔩
スリナム	スリナム 🇸🇷
プラス	プラス ➕️
毛虫	毛虫 🐛
5じはん	5じはん 🕠️
じゅしんばこ	じゅしんばこ 📥️ 📨
科学	科学 📡 🔍️ 🔎 🔬 🔭 🦠 🧪
じぐそーぱずる	じぐそーぱずる 🧩
むしめがねひだり	むしめがねひだり 🔍️
いりょうのしんぼる	いりょうのしんぼる ⚕️
ティールブルー	ティールブルー 🩵
はりねずみ	はりねずみ 🦔 🦔
眠い	眠い 😪 😴 🥱 🫩
オーバー	オーバー 🧥
ハートのびっくり	ハートのびっくり ❣️
ボトル	ボトル 🍾
信号横	信号横 🚥
八角形	八角形 🛑
しんぶんし	しんぶんし 📰 🗞️
テイクアウト弁当	テイクアウト弁当 🥡
すてぃっく	すてぃっく 🏑 🏒 🕹️ 🥍
日暮れ	日暮れ 🌇
すいどう	すいどう 🚰
オリエンテーリング	オリエンテーリング 🧭
白い疑問符	白い疑問符 ❔️
まいく	まいく 🎙️ 🎤
映画（カチンコ）	映画（カチンコ） 🎬️
女の子	女の子 👧 👨‍👧 👨‍👧‍👦 👨‍👧‍👧 👨‍👨‍👧 👨‍👨‍👧‍👦 👨‍👨‍👧‍👧 👨‍👩‍👧 👨‍👩‍👧‍👦 👨‍👩‍👧‍👧 👩‍👧 👩‍👧‍👦 👩‍👧‍👧 👩‍👩‍👧 👩‍👩‍👧‍👦 👩‍👩‍👧‍👧
手（パンチ）	手（パンチ） 👊
ないこうてき	ないこうてき 🫥
フォーマル	フォーマル 🤵
信号機	信号機 🚥 🚦
車椅子	車椅子 ♿️ 🦼 🦽
初月	初月 🌒
むじんとう	むじんとう 🏝️
霧の都会	霧の都会 🌁
こうそくじょうぼたん	こうそくじょうぼたん ⏫️
ちんげんさい	ちんげんさい 🥬
眠る	眠る 😪 😴
指	指 ✌️ 🈯️ 👆️ 👇️ 👈️ 👉️ 🖕 🤌 🤏 🤞 🫰 🫵
受信機	受信機 📻️
無料	無料 🆓 🈚️
ぽんどさつ	ぽんどさつ 💷
きゃー	きゃー 😆 😆
かいじょけん	かいじょけん 🐕‍🦺
ジト目	ジト目 😒
こいのぼり	こいのぼり 🎏 🎏
すいむうぇあ	すいむうぇあ 🩱 🩲 🩳
へりこぷたー	へりこぷたー 🚁
交差した旗	交差した旗 🎌
みぎうえ	みぎうえ ↗️
えーっ	えーっ 😲 😲 😳 😳
ししざ	ししざ ♌️ 🦁
山高帽	山高帽 🎩
おおきくなるはーと	おおきくなるはーと 💗
せじょう	せじょう 🔒️
いわざる	いわざる 🙊
ベッド	ベッド 🛌 🛏️
居待月	居待月 🌖
かいじょう	かいじょう 🔑 🔓️
れいじ	れいじ 🕛️
こうぐばこ	こうぐばこ 🧰
たんご	たんご 💃 🕺
ししゃ	ししゃ ⚰️ 💀
計算	計算 ➖️ 🧮
なきわらい	なきわらい 😂 🤣
かっぱつ	かっぱつ 🤸 🤸‍♀️ 🤸‍♂️
隠す	隠す 🙈
くちがひらいたかお	くちがひらいたかお 😮
ふぁいやー	ふぁいやー 🔥
フィジー	フィジー 🇫🇯
おてあげするひと	おてあげするひと 🤷
ファイル	ファイル 📁 📂 🗃️ 🗄️
せいべつ	せいべつ ⚧️
すてーしょん	すてーしょん 🚉
婚約指輪	婚約指輪 💍
あすたりすく	あすたりすく ✳️ ❇️
角帽	角帽 🎓️ 👨‍🎓 👩‍🎓 🧑‍🎓
ケバブ	ケバブ 🥙
バレエシューズ	バレエシューズ 🥿 🩰
さくらんぼ	さくらんぼ 🍒 🍒
しかめっつら	しかめっつら 😬 🙍 🙍‍♀️ 🙍‍♂️
ふつりょうぎあな	ふつりょうぎあな 🇬🇫
開錠	開錠 🔑
練り物	練り物 🍢 🍥
どーどー	どーどー 🦤
ふあ～	ふあ～ 🥱
ちからこぶ	ちからこぶ 💪
かたーる	かたーる 🇶🇦
とりももにく	とりももにく 🍗
体操	体操 🤸 🤸‍♀️ 🤸‍♂️
えんとつ	えんとつ 🏭️
いべんと	いべんと 🎪
まほう	まほう 🔮 🧙 🧚 🧝 🪄
がんぐ	がんぐ 🧸 🪀 🪁 🪃
ぶろんとさうるす	ぶろんとさうるす 🦕
はつねつ	はつねつ 🥵
みぎまわり	みぎまわり 🔃
真珠	真珠 🦪
しんぱい	しんぱい 😟
馬（首）	馬（首） 🐴
男子トイレ	男子トイレ 🚹️
いしゃ	いしゃ ⚕️ 🏥 👨‍⚕️ 👩‍⚕️ 💉 💊 🥼 🧑‍⚕️ 🩸 🩺 🩻
ゼムクリップ	ゼムクリップ 📎
しょうげき	しょうげき 💥
玩具	玩具 🧸 🪀 🪁 🪃
顔のある下弦の月	顔のある下弦の月 🌜️
レーシングカー	レーシングカー 🏎️
赤ちゃん天使	赤ちゃん天使 👼
しんぱく	しんぱく 🫀
鋭い	鋭い 🪒
サントメ・プリンシペ	サントメ・プリンシペ 🇸🇹
うつろな目	うつろな目 🥴
!?	!? ⁉️ ⁉️
あかいかんたんふ	あかいかんたんふ ❗️
カナダ	カナダ 🇨🇦
ナザール・ボンジュウ	ナザール・ボンジュウ 🧿
たい	たい 🆚 🇹🇭 👔
もーりたにあ	もーりたにあ 🇲🇷
じょせいうちゅうひこうし	じょせいうちゅうひこうし 👩‍🚀
たーばんのひと	たーばんのひと 👳
ペルー	ペルー 🇵🇪
かき氷	かき氷 🍧
めがまわる	めがまわる 💫 😵‍💫
息を吐く顔	息を吐く顔 😮‍💨
たぐ	たぐ 🏷️ 🔖
はろうぃーん	はろうぃーん 🎃 👻 🧛 🧟
たけ	たけ 🎍
たこ	たこ 🐙 🐙 🪁 🪁
実	実 🫒
さけんでいるかお	さけんでいるかお 😱
ベラルーシ	ベラルーシ 🇧🇾
あんないじょ	あんないじょ ℹ️
むし	むし 🐌 🐛 🐜 🐝 🐞 🕷️ 🦂 🦋 🦗 🦟 🪰 🪱 🪲 🪳
寝待月	寝待月 🌖
弁当箱	弁当箱 🍱
たす	たす ➕️
かなづち	かなづち ⚒️ ⚒️ 🔨 🔨 🛠️ 🛠️
きょがん	きょがん 🪨
れすらー	れすらー 🤼
ただ	ただ 🆓 🈚️
つまんでいるゆび	つまんでいるゆび 🤏
SUV車	SUV車 🚙
ムービー	ムービー 🎞️ 🎥 📹️ 📽️
たつ	たつ 🐲
もにたー	もにたー 🖥️
みつまた	みつまた 🔱
たて	たて 🛡️
風呂	風呂 🚿 🛀 🛁 🧼
ギニア	ギニア 🇬🇳
にんにく	にんにく 🧄
とれーらー	とれーらー 🚛
こうかい	こうかい 🧭
むれ	むれ 🦬
ばくちく	ばくちく 🧨
家	家 🏘️ 🏚️ 🏠️ 🏡 🛖
杖をついた男性	杖をついた男性 👨‍🦯 👨‍🦯‍➡️
けしょうしつ	けしょうしつ 🚹️ 🚺️ 🚻 🚾
めをとじてきす	めをとじてきす 😚
人差し指と小指を立てた手	人差し指と小指を立てた手 🤘
受付	受付 💁
のうか	のうか 👨‍🌾 👩‍🌾 🧑‍🌾
曇り	曇り ☁️ ⛅️ 🌥️ 🌦️ 🌫️
ATM	ATM 🏧
困惑	困惑 😕 😖 🫤
ＩＤ	ＩＤ 🆔
警察官	警察官 👮 👮‍♀️ 👮‍♂️
ワイン	ワイン 🍷
おやゆびサイン	おやゆびサイン 👍️
あおいしかく	あおいしかく 🟦
たま	たま 🎳 🔮
チュッ	チュッ 😘
スロットマシン	スロットマシン 🎰
スーパーマン	スーパーマン 🦸
「！？」	「！？」 ⁉️
ゆきやま	ゆきやま 🏔️
にほん	にほん 🇯🇵 🎋 🎌 🎍 🎎 🏯 🗾
キックスケーター	キックスケーター 🛴
バンド	バンド 🪈
たーきー	たーきー 🦃
パーティ	パーティ 👯
笑い転げる	笑い転げる 🤣
サッカーボール	サッカーボール ⚽️
ぷらんじゃー	ぷらんじゃー 🪠
てのこうじょうゆびさし	てのこうじょうゆびさし 👆️
寺	寺 🛕
なぐさめ	なぐさめ 🫂
AB型	AB型 🆎
すらいだー	すらいだー 🎚️
曲げた脚	曲げた脚 🦵
対	対 🆚
おんどけい	おんどけい 🌡️
派手	派手 🦚 🦩
おとこのこ	おとこのこ 👦 👨‍👦 👨‍👦‍👦 👨‍👧‍👦 👨‍👨‍👦 👨‍👨‍👦‍👦 👨‍👨‍👧‍👦 👨‍👩‍👦 👨‍👩‍👦‍👦 👨‍👩‍👧‍👦 👩‍👦 👩‍👦‍👦 👩‍👧‍👦 👩‍👩‍👦 👩‍👩‍👦‍👦 👩‍👩‍👧‍👦
お手上げする男	お手上げする男 🤷‍♂️
のうふ	のうふ 👨‍🌾
ディプロドクス	ディプロドクス 🦕
ハニー	ハニー 🍯
月額	月額 🈷️
むすびめ	むすびめ 🪢
ドイツ	ドイツ 🇩🇪
8時半	8時半 🕣️
笑顔	笑顔 ☺️ 😀 😁 😂 😃 😄 😅 😆 😇 😈 😋 😍 😎 😙 😸 😹 😺 😻 🙂 🙃 🤗 🤣 🤩 🤭 🥰 🥳
石油	石油 🛢️
2人	2人 👥
すいてき	すいてき 💦 💧
悪役	悪役 🦹
黄色いハート	黄色いハート 💛
支払い	支払い 💳️ 💸
ぶーたん	ぶーたん 🇧🇹
チュー	チュー 💏
とりだしぼたん	とりだしぼたん ⏏️
きかいこう	きかいこう 🧰
電源OFF	電源OFF 📴
ON矢印	ON矢印 🔛
怒りの吹き出し	怒りの吹き出し 🗯️
くやしい	くやしい 🫦
観覧車	観覧車 🎡
山	山 ⛰️ 🌋 🏔️ 🏕️ 🗻 🚵 🧗
わっふる	わっふる 🧇
はいいろのはーと	はいいろのはーと 🩶
にゅうじょうけん	にゅうじょうけん 🎟️ 🎫
やもり	やもり 🦎
リュージュ	リュージュ 🛷
くやしさ	くやしさ 🫦
コンセント	コンセント 🔌
マスク	マスク 😷 🤿
記号	記号 ©️ ®️ ‼️ ⁉️ ™️ ☑️ ✅️ ✔️ ✖️ ✳️ ✴️ ❇️ ❌️ ❎️ ❓️ ❔️ ❕️ ❗️ ➕️ ➖️ ➗️ ➰️ ➿️ ⭕️ 〰️ 〽️ 🔣
赤ちゃんマーク	赤ちゃんマーク 🚼️
チケット	チケット 🎟️ 🎫
花飾り	花飾り 🏵️
岩	岩 🪨
とらんすじぇんだーのまーく	とらんすじぇんだーのまーく ⚧️
ペンギン	ペンギン 🐧
乗用車	乗用車 🚗 🚘️ 🚙
サン・マルタン	サン・マルタン 🇲🇫
電話２	電話２ 📞
そうしんとれい	そうしんとれい 📤️
電話３	電話３ 📱
みどり	みどり 🍋‍🟩 💚 🟢 🟩 🪴
2位	2位 🥈
土下座	土下座 🙇 🙇‍♀️ 🙇‍♂️
でぃやらんぷ	でぃやらんぷ 🪔
ビーサン	ビーサン 🩴
ロッカー	ロッカー 🛅 🧑‍🎤
ボート	ボート 🚣 🚣‍♀️ 🚤 🛥️ 🛶
ろーまじ	ろーまじ 🔠 🔡 🔤
ボード	ボード 🛹
焼き菓子	焼き菓子 🧇
かんだんけい	かんだんけい 🌡️
サウナに入る男	サウナに入る男 🧖‍♂️
輪廻	輪廻 🐦‍🔥
シカ	シカ 🦌
へいわのしんぼる	へいわのしんぼる ☮️
月餅	月餅 🥮
受信	受信 📥️ 📩 📲
ヘビ	ヘビ 🐍
かぷせる	かぷせる 💊
レインボーフラッグ	レインボーフラッグ 🏳️‍🌈
ピーマン	ピーマン 🫑
婦人靴	婦人靴 👠 👡 👢
更新	更新 🆙 🔄
フランクフルト	フランクフルト 🌭
木の葉	木の葉 🍂 🍃
ふらんくふると	ふらんくふると 🌭
島	島 🏝️
ボール	ボール ⚽️ ⚾️ 🎱 🎳 🎾 🏀 🏈 🏉 🏏 🏐 🏑 🏓 🤾 🤾‍♀️ 🥍 🥎
指摘	指摘 🫵
みくろねしあれんぽう	みくろねしあれんぽう 🇫🇲
ジャケット	ジャケット 🧥
少女	少女 👧
鼓動	鼓動 💓 🫀
いーぐる	いーぐる 🦅
うわの空	うわの空 😶‍🌫️
つぎへ	つぎへ ▶️
時計（３時）	時計（３時） 🕒️
ヘリ	ヘリ 🚁
けいとだま	けいとだま 🧶
ぴーす	ぴーす ✌️ 🧩
サクソフォン	サクソフォン 🎷
ぴーち	ぴーち 🍑
よこぶえ	よこぶえ 🪈
はなす	はなす 🗣️
Pマーク	Pマーク 🅿️
でぃぷろどくす	でぃぷろどくす 🦕
こうくうき	こうくうき ✈️ 🛩️ 🛫 🛬
お菓子	お菓子 🍘 🍩 🍪 🍫 🍬 🍭 🍮 🍰 🍿 🎂 🥧 🧁
安全	安全 🔐 🛟 🦺
獅子座	獅子座 ♌️
アラーム	アラーム ⏰️
めかにっく	めかにっく 👨‍🔧 👩‍🔧 🧑‍🔧 🧰
ケーブルカー	ケーブルカー 🚠
しごせんのあるちきゅう	しごせんのあるちきゅう 🌐
斧	斧 🪓
おじぎする男	おじぎする男 🙇‍♂️
さいくりすと	さいくりすと 🚴 🚴‍♀️ 🚵 🚵‍♀️
口ひげ	口ひげ 🥸
ココナツ	ココナツ 🥥
はなび	はなび 🎆 🎇 🧨
だんまり	だんまり 😶 😶
ターバン	ターバン 👳 👳‍♀️ 👳‍♂️
新	新 🆕
0けい	0けい 🚅
ちーず	ちーず 🍕 🧀 🪤 🫕
じょりーろじゃー	じょりーろじゃー 🏴‍☠️
すてーきにく	すてーきにく 🥩
ゆだやきょう	ゆだやきょう ✡️ 🔯 🕍 🕎
旗	旗 ⛳️ 🇦🇨 🇦🇩 🇦🇪 🇦🇫 🇦🇬 🇦🇮 🇦🇱 🇦🇲 🇦🇴 🇦🇶 🇦🇷 🇦🇸 🇦🇹 🇦🇺 🇦🇼 🇦🇽 🇦🇿 🇧🇦 🇧🇧 🇧🇩 🇧🇪 🇧🇫 🇧🇬 🇧🇭 🇧🇮 🇧🇯 🇧🇱 🇧🇲 🇧🇳 🇧🇴 🇧🇶 🇧🇷 🇧🇸 🇧🇹 🇧🇻 🇧🇼 🇧🇾 🇧🇿 🇨🇦 🇨🇨 🇨🇩 🇨🇫 🇨🇬 🇨🇭 🇨🇮 🇨🇰 🇨🇱 🇨🇲 🇨🇳 🇨🇴 🇨🇵 🇨🇷 🇨🇺 🇨🇻 🇨🇼 🇨🇽 🇨🇾 🇨🇿 🇩🇪 🇩🇬 🇩🇯 🇩🇰 🇩🇲 🇩🇴 🇩🇿 🇪🇦 🇪🇨 🇪🇪 🇪🇬 🇪🇭 🇪🇷 🇪🇸 🇪🇹 🇪🇺 🇫🇮 🇫🇯 🇫🇰 🇫🇲 🇫🇴 🇫🇷 🇬🇦 🇬🇧 🇬🇩 🇬🇪 🇬🇫 🇬🇬 🇬🇭 🇬🇮 🇬🇱 🇬🇲 🇬🇳 🇬🇵 🇬🇶 🇬🇷 🇬🇸 🇬🇹 🇬🇺 🇬🇼 🇬🇾 🇭🇰 🇭🇲 🇭🇳 🇭🇷 🇭🇹 🇭🇺 🇮🇨 🇮🇩 🇮🇪 🇮🇱 🇮🇲 🇮🇳 🇮🇴 🇮🇶 🇮🇷 🇮🇸 🇮🇹 🇯🇪 🇯🇲 🇯🇴 🇯🇵 🇰🇪 🇰🇬 🇰🇭 🇰🇮 🇰🇲 🇰🇳 🇰🇵 🇰🇷 🇰🇼 🇰🇾 🇰🇿 🇱🇦 🇱🇧 🇱🇨 🇱🇮 🇱🇰 🇱🇷 🇱🇸 🇱🇹 🇱🇺 🇱🇻 🇱🇾 🇲🇦 🇲🇨 🇲🇩 🇲🇪 🇲🇫 🇲🇬 🇲🇭 🇲🇰 🇲🇱 🇲🇲 🇲🇳 🇲🇴 🇲🇵 🇲🇶 🇲🇷 🇲🇸 🇲🇹 🇲🇺 🇲🇻 🇲🇼 🇲🇽 🇲🇾 🇲🇿 🇳🇦 🇳🇨 🇳🇪 🇳🇫 🇳🇬 🇳🇮 🇳🇱 🇳🇴 🇳🇵 🇳🇷 🇳🇺 🇳🇿 🇴🇲 🇵🇦 🇵🇪 🇵🇫 🇵🇬 🇵🇭 🇵🇰 🇵🇱 🇵🇲 🇵🇳 🇵🇷 🇵🇸 🇵🇹 🇵🇼 🇵🇾 🇶🇦 🇷🇪 🇷🇴 🇷🇸 🇷🇺 🇷🇼 🇸🇦 🇸🇧 🇸🇨 🇸🇩 🇸🇪 🇸🇬 🇸🇭 🇸🇮 🇸🇯 🇸🇰 🇸🇱 🇸🇲 🇸🇳 🇸🇴 🇸🇷 🇸🇸 🇸🇹 🇸🇻 🇸🇽 🇸🇾 🇸🇿 🇹🇦 🇹🇨 🇹🇩 🇹🇫 🇹🇬 🇹🇭 🇹🇯 🇹🇰 🇹🇱 🇹🇲 🇹🇳 🇹🇴 🇹🇷 🇹🇹 🇹🇻 🇹🇼 🇹🇿 🇺🇦 🇺🇬 🇺🇲 🇺🇳 🇺🇸 🇺🇾 🇺🇿 🇻🇦 🇻🇨 🇻🇪 🇻🇬 🇻🇮 🇻🇳 🇻🇺 🇼🇫 🇼🇸 🇽🇰 🇾🇪 🇾🇹 🇿🇦 🇿🇲 🇿🇼 🎌 🏁 🏳️ 🏳️‍⚧️ 🏴 🏴󠁧󠁢󠁥󠁮󠁧󠁿 🏴󠁧󠁢󠁳󠁣󠁴󠁿 🏴󠁧󠁢󠁷󠁬󠁳󠁿 🚩
ハスの花	ハスの花 🪷
白四角特大	白四角特大 ⬜️
歯磨き	歯磨き 🪥
とじ傘	とじ傘 🌂
雪だるまと雪	雪だるまと雪 ☃️
りゅう	りゅう 🐉 🐲
みずがめ	みずがめ 🏺
割引	割引 🈹
むまーく	むまーく 🈚️
ぜん	ぜん 🦸 🦸‍♀️ 🦸‍♂️ 🧘
ぎもんふ	ぎもんふ ❓️ ❔️ ❕️
スコッチ	スコッチ 🥃
とらいでんと	とらいでんと 🔱
お断り	お断り 🙅
はてなマーク	はてなマーク ⁉️ ❓️ ❔️
てんぷら	てんぷら 🍤
せるびあ	せるびあ 🇷🇸
ＦＤ	ＦＤ 💾
キャッスル	キャッスル 🏰
びーちぱらそる	びーちぱらそる 🏖️
送信ＢＯＸ	送信ＢＯＸ 📤️
はんけん	はんけん 🎟️ 🎫
振動	振動 🫨
はんどぼーるをするおんな	はんどぼーるをするおんな 🤾‍♀️
興奮	興奮 🤸 🤸‍♀️ 🤸‍♂️
いりょうきぐ	いりょうきぐ 💉
かえで	かえで 🍁 🍁
星	星 ☪️ ✡️ ✨️ ✴️ ⭐️ 🌃 🌟 🌠 💫 🔯 🤩 🪐
そろもんしょとう	そろもんしょとう 🇸🇧
スコップ	スコップ 🪏
クロワッサン	クロワッサン 🥐
みどりのしかく	みどりのしかく 🟩
まだがすかる	まだがすかる 🇲🇬
しょくしゅ	しょくしゅ 🪼
かえる	かえる 🐸 🐸
女性の医者	女性の医者 👩‍⚕️
ラインダンス	ラインダンス 👯
巣	巣 🪹 🪺
ののしり	ののしり 🤬 🤬
ののしる	ののしる 🤬 🤬
複数の家	複数の家 🏘️
城（日本）	城（日本） 🏯
左	左 ↩️ ⬅️ 👈️ 🤛
じゅしんなし	じゅしんなし 📥️
赤ん坊	赤ん坊 👶 🚼️
そうしんする	そうしんする 📩
手のひらを揃えた両手	手のひらを揃えた両手 🤲
コンビニ	コンビニ 🏪
だいやもんど	だいやもんど 💍 💎
絵筆	絵筆 🖌️
笹飾り	笹飾り 🎋
ボリューム	ボリューム 🔈️ 🔉 🔊
こうえん	こうえん ⛲️ 🏞️ 🛝
リトアニア	リトアニア 🇱🇹
シーフード	シーフード 🥘 🦐 🦑 🦞 🦪
にちぼつ	にちぼつ 🌇
こぎって	こぎって 💴
アザラシ	アザラシ 🦭
コンゴ民主共和国(キンシャサ)	コンゴ民主共和国(キンシャサ) 🇨🇩
こつつぼ	こつつぼ ⚱️
トレーラー	トレーラー 🚛
いんたーねっと	いんたーねっと 🌐 🛜
だんせいとおとこのことおとこのこのかぞく	だんせいとおとこのことおとこのこのかぞく 👨‍👦‍👦
ひろう	ひろう 🫳
チェッカーフラッグ	チェッカーフラッグ 🏁
アコーディオン	アコーディオン 🪗
カウボーイの顔	カウボーイの顔 🤠
ガンビア	ガンビア 🇬🇲
劇場	劇場 🎭️
ナイフとフォーク	ナイフとフォーク 🍴
席	席 💺
タルト	タルト 🥧
マッシュルーム	マッシュルーム 🍄 🍄‍🟫
みぎむきさんかく	みぎむきさんかく ▶️
ふぃっしんぐ	ふぃっしんぐ 🎣 🐟️
くみあわせ	くみあわせ 🧩
踊る女	踊る女 💃
えんぶれむ	えんぶれむ ⚜️ 🔱
引っ掛け	引っ掛け 🪝
こくちょう	こくちょう 🐦‍⬛
むかっ（怒り）	むかっ（怒り） 💢
ココナッツ	ココナッツ 🥥
まきぺーじ	まきぺーじ 📃
うちゅうりょこう	うちゅうりょこう 🚀
おーけーのて	おーけーのて 👌
白十字ヘルメット	白十字ヘルメット ⛑️
著作権	著作権 ©️
どらごんのかお	どらごんのかお 🐲
もるでぃぶ	もるでぃぶ 🇲🇻
よるのはし	よるのはし 🌉
ドキュメント	ドキュメント 📃 📄
げんし	げんし ⚛️
こんにちは	こんにちは 🫂 🫂
可能	可能 🉑
ばいせくしゅある	ばいせくしゅある 🌈 🏳️‍🌈
げんそ	げんそ ⚛️
めのーらー	めのーらー 🕎
たきしーどのおとこ	たきしーどのおとこ 🤵‍♂️
オーランド諸島	オーランド諸島 🇦🇽
店	店 🏪
からおけ	からおけ 🎤
ふぇいすまっさーじ	ふぇいすまっさーじ 💆 💆‍♀️ 💆‍♂️
びすく	びすく 🦞
せいびし	せいびし 🧑‍🔧 🧰
あんどら	あんどら 🇦🇩
きらきらぼし	きらきらぼし 🌟
コソボ	コソボ 🇽🇰
月	月 🈷️ 🌑 🌒 🌓 🌔 🌕️ 🌖 🌗 🌘 🌙 🌚 🌛 🌜️ 🌝 🎑
有	有 🈶
服	服 👔 👕 👖 👗 👘 👚 🥻 🥼 🧥
庭	庭 🏡
ばんがろー	ばんがろー 🛖
虫眼鏡右	虫眼鏡右 🔎
フグ	フグ 🐡
男の魔法使い	男の魔法使い 🧙‍♂️
こむぎ	こむぎ 🍞
まるいおしぴん	まるいおしぴん 📍
つかれ	つかれ 😩 😫 🥱
ばらんすえんぎ	ばらんすえんぎ 🤹 🤹‍♂️
朝	朝 🌄 🌅
ゴミ	ゴミ 🚯
はぬかー	はぬかー 🕎
みかくにんひこうぶったい	みかくにんひこうぶったい 🛸
ランプ	ランプ 🛋️ 🪔
共感	共感 😮
しょうがい	しょうがい 👨‍🦯 👨‍🦯‍➡️ 👨‍🦼 👨‍🦼‍➡️ 👨‍🦽 👨‍🦽‍➡️ 👩‍🦯 👩‍🦯‍➡️ 👩‍🦼 👩‍🦼‍➡️ 👩‍🦽 👩‍🦽‍➡️ 🦮 🦯 🧏 🧏‍♀️ 🧏‍♂️ 🧑‍🦯 🧑‍🦯‍➡️ 🧑‍🦼 🧑‍🦼‍➡️ 🧑‍🦽 🧑‍🦽‍➡️ 🩼
木	木 🌲 🌳 🌴 🪓 🪵
映写機	映写機 📽️
ポリバケツ	ポリバケツ 🪣
べいりょうゔぁーじんしょとう	べいりょうゔぁーじんしょとう 🇻🇮
とめぴん	とめぴん 🧷
本	本 📔 📕 📖 📗 📘 📙 📚️
しえられおね	しえられおね 🇸🇱
GLBT	GLBT 🌈 🌈 🏳️‍🌈 🏳️‍🌈
やくもの	やくもの ‼️ ✳️ ✴️ ❇️ ❓️ ❔️ ❕️ ❗️ 〰️ 〽️
立ち入り禁止	立ち入り禁止 ⛔️
弓	弓 🏹
じょーかー	じょーかー 🃏
7じ30ふん	7じ30ふん 🕢️
杖	杖 🩼 🪄
きょうき	きょうき 🔪
きょうぎ	きょうぎ 🚵
おじぎ	おじぎ 🙇 🙇 🙇‍♀️ 🙇‍♀️ 🙇‍♂️ 🙇‍♂️
およぐおとこ	およぐおとこ 🏊‍♂️
手紙	手紙 ✉️ 💌 📧 📨 📮
三猿	三猿 🙈 🙉 🙊
ここのまーく	ここのまーく 🈁
モンゴル	モンゴル 🇲🇳
リベリア	リベリア 🇱🇷
微生物	微生物 🦠
きょうし	きょうし 👨‍🏫 👩‍🏫 🧑‍🏫
うぇいとりふてぃんぐ	うぇいとりふてぃんぐ 🏋️ 🏋️‍♀️ 🏋️‍♂️
上カーブ矢印	上カーブ矢印 ⤴️
しろぬきのばつ	しろぬきのばつ ❎️
大四角１	大四角１ ◻️ ◼️
きゅらそー	きゅらそー 🇨🇼
ネットワーク	ネットワーク 🛜
ルワンダ	ルワンダ 🇷🇼
しょうがつ	しょうがつ 🎍
国旗（スペイン）	国旗（スペイン） 🇪🇸
すき	すき 🩵 🩶 🩷 🪏
すぐ	すぐ 🔜 🔜
サンゴ	サンゴ 🪸
東	東 ➡️
ラブレター	ラブレター 💌
ストロー	ストロー 🧃
バヌアツ	バヌアツ 🇻🇺
すし	すし 🍣 🍣
スキンヘッド	スキンヘッド 🦲
10	10 🔟 🔟
ファックス	ファックス 📠
すず	すず 🎐 🔔 🔕
フィギュアスケート	フィギュアスケート ⛸️
サンタ	サンタ 🎅 🧑‍🎄
ふじんぐつ	ふじんぐつ 👠 👡 👢
小切手（CHECK）	小切手（CHECK） 💴
赤い本	赤い本 📕
きょうふ	きょうふ 😱 🧛 🧟
板	板 🎿
バイバイ	バイバイ 👋
ハイチ	ハイチ 🇭🇹
きゅうけつき	きゅうけつき ⚰️ 🦇 🧛 🧛‍♀️ 🧛‍♂️
ポケットベル	ポケットベル 📟️
ばんざい	ばんざい 🙌
日本茶	日本茶 🍵
ファイヤー	ファイヤー 🔥
すな	すな ⌛️ ⏳️
ゆうまーく	ゆうまーく 🈶
ぐるぐる	ぐるぐる 🌀
女の魔法使い	女の魔法使い 🧙‍♀️
ひきざん	ひきざん ➖️
無神論	無神論 ⚛️
8時	8時 🕗️
にふだ	にふだ 🏷️
すぱ	すぱ 💆 🧖
あたらしい	あたらしい 🆕
かんらんしゃ	かんらんしゃ 🎡
ホットドリンク	ホットドリンク ☕️
得	得 🉐
ＣＤ	ＣＤ 💿️ 💿️
おくとーばーふぇすと	おくとーばーふぇすと 🍺
れっしゃ	れっしゃ 🚂 🚃 🚆 🚉
ゆうびんばこ	ゆうびんばこ 📪️ 📫️ 📬️ 📭️ 📮
ひゃっかてん	ひゃっかてん 🏬
当たり	当たり 🎯
すみ	すみ ☑️ ✅️ ✔️
おいしい	おいしい 😋 😋
ＣＬ	ＣＬ 🆑
取っ組み合い	取っ組み合い 🤼 🤼‍♀️ 🤼‍♂️
もちもの	もちもの ☂️ ☔️ 🌂
くちをとがらせたおとこ	くちをとがらせたおとこ 🙎‍♂️
8時30分	8時30分 🕗️ 🕣️
ネパール	ネパール 🇳🇵
悪玉	悪玉 🦹
こううんを	こううんを 🤞
レスキュー	レスキュー 🛟 🧑‍🚒
ダンサー	ダンサー 👯 👯‍♀️ 👯‍♂️ 💃 🕺
石碑	石碑 🪦
赤毛	赤毛 👨‍🦰 👩‍🦰 🦰 🧑‍🦰
いかりのふきだし	いかりのふきだし 🗯️
クロス	クロス ✝️
栗	栗 🌰
まんしゃ	まんしゃ 🈵
ブイエス	ブイエス 🆚
不死鳥	不死鳥 🐦‍🔥
まんしつ	まんしつ 🈵
スノーボード	スノーボード 🏂️
あかいはーと	あかいはーと ❤️
ブライトネス	ブライトネス 🔅 🔆
人差し指サイン	人差し指サイン ☝️
キリバス	キリバス 🇰🇮
救命具	救命具 🛟
桃	桃 🍑
くのう	くのう 😧
筋肉	筋肉 💪
ひどい	ひどい 😢 😢
害虫	害虫 🪰 🪳
株	株 💹
ねずみ捕り	ねずみ捕り 🪤
ドライバー	ドライバー 🪛
ステーキ肉	ステーキ肉 🥩
入力	入力 🔠 🔡 🔢 🔣 🔤
火	火 🔥
げすとあかうんと	げすとあかうんと 👤
炎	炎 ❤️‍🔥 🔥
表情（しらー）	表情（しらー） 😒
変装した顔	変装した顔 🥸
シルクハット	シルクハット 🎩
イングランド	イングランド 🏴󠁧󠁢󠁥󠁮󠁧󠁿
バスケットボールをする人	バスケットボールをする人 ⛹️
探偵	探偵 🕵️ 🕵️‍♀️ 🕵️‍♂️
桜	桜 🌸
じゅうでんぶそく	じゅうでんぶそく 🪫
おびき寄せる	おびき寄せる 🪤
話す人のシルエット	話す人のシルエット 🗣️
ギリシャ	ギリシャ 🇬🇷
ひんどぅーきょうのじいん	ひんどぅーきょうのじいん 🛕
インターネット	インターネット 🌐 🛜
シネマ	シネマ 🎞️ 🎥
きゅうきゅうしゃ	きゅうきゅうしゃ 🚑️
緑のハート	緑のハート 💚
ひだりゆびさし	ひだりゆびさし 👈️
Cマーク	Cマーク ©️
もるどば	もるどば 🇲🇩
年配	年配 🦳
チュニジア	チュニジア 🇹🇳
さうなにはいるおとこ	さうなにはいるおとこ 🧖‍♂️
パーティー	パーティー 🎉 🎊 👯‍♀️ 👯‍♂️ 🥳 🪅 🪇 🪩
烏	烏 🐦‍⬛
涙ぽろり	涙ぽろり 😢
グレープ	グレープ 🍇
パスタ	パスタ 🍝
跳ね返り	跳ね返り 🪃
まじゅつ	まじゅつ 🪄
ぺーじ	ぺーじ 📄
ぱっきんぐ	ぱっきんぐ 🧳
ハート	ハート ♥️ ❣️ ❤️ ❤️‍🔥 ❤️‍🩹 👨‍❤️‍👨 👨‍❤️‍💋‍👨 👩‍❤️‍👨 👩‍❤️‍👩 👩‍❤️‍💋‍👨 👩‍❤️‍💋‍👩 💌 💏 💑 💓 💔 💕 💖 💗 💘 💙 💚 💛 💜 💝 💞 💟 🖤 😍 😘 😻 🤍 🤎 🥰 🧡 🩵 🩶 🩷 🫶
エルサルバドル	エルサルバドル 🇸🇻
おいすたー	おいすたー 🦪
VS（Versus)	VS（Versus) 🆚
のるうぇー	のるうぇー 🇳🇴
もひーと	もひーと 🍋‍🟩
てぃーじー	てぃーじー ⚧️ 🏳️‍⚧️
りょうかい	りょうかい 👍️ 🫡
ありがとう	ありがとう 🙏 🙏 🫂 🫂
ハーブ	ハーブ 🌿 🫚
ショートケーキ	ショートケーキ 🍰
授乳する女性	授乳する女性 👩‍🍼
ハープ	ハープ 🪉
えきすぱーと	えきすぱーと 🤓
こっぷからそそぐ	こっぷからそそぐ 🫗
ぶるれい	ぶるれい 💿️ 📀
ちぇっかー	ちぇっかー 🏁
幽霊	幽霊 👻
姉妹	姉妹 👭
ぽーかーふぇいす	ぽーかーふぇいす 😐️
あくにん	あくにん 🦹
猪口	猪口 🍶
あんてな	あんてな 📡
ビーバー	ビーバー 🦫
スロット	スロット 🎰
東ティモール	東ティモール 🇹🇱
ろっく	ろっく 🔏 🔐 🔒️ 🔓️
ケガ	ケガ ❤️‍🩹 🤕
天国	天国 🪽
手を挙げる	手を挙げる 🙋 🙋‍♀️ 🙋‍♂️
べーるのだんせい	べーるのだんせい 👰‍♂️
野球ボール	野球ボール ⚾️
清浄	清浄 🪷
無	無 🈚️
椎茸	椎茸 🍄‍🟫
正午	正午 🕛️
お年寄り	お年寄り 👴 👵 🧓
0系新幹線	0系新幹線 🚅
オクトーバーフェスト	オクトーバーフェスト 🍺
カウボーイ	カウボーイ 🤠
まてぃーに	まてぃーに 🍸️
らけっと	らけっと 🎾 🏓 🏸
信じられない	信じられない 😮 🤦 🤦‍♀️ 🤦‍♂️
森	森 🌲 🌳
フライパン	フライパン 🍳
音量大	音量大 🔊
再生／一時停止ボタン	再生／一時停止ボタン ⏯️
ぐらふしたむき	ぐらふしたむき 📉
まるいぼたん	まるいぼたん ⚪️ ⚫️ 🔴 🔵 🟠 🟡 🟢 🟣 🟤
しんとう	しんとう ⛩️
角氷	角氷 🧊
まんが	まんが 💡 💢 💤 💥 💨 💬 💭
キドニービーンズ	キドニービーンズ 🫘
棺	棺 ⚰️
あうとどあ	あうとどあ 🥾
キャベツ	キャベツ 🥬
9:00	9:00 🕘️ 🕘️
肉まん	肉まん 🥟
こぜに	こぜに 🪙
ベルボーイベル	ベルボーイベル 🛎️
自動車正面	自動車正面 🚘️
新聞	新聞 📰 🗞️
海綿	海綿 🧽
かまーく	かまーく 🉑
おさけ	おさけ 🍷 🍸️ 🍹 🍺
おさげ	おさげ 👧 👧
熊	熊 🐻
ロザリオ	ロザリオ 📿
スーパー	スーパー 🛒
カメルーン	カメルーン 🇨🇲
英大文字の入力	英大文字の入力 🔠
天体	天体 🪐
ぎょかい	ぎょかい 🦪
りんくしんぼる	りんくしんぼる 🔗
おひな様	おひな様 🎎
給油	給油 ⛽️
ちけっと	ちけっと 🎟️ 🎫
どくしょ	どくしょ 📖 📗 📘 📙 📚️
あいかた	あいかた 👯
ちゅうかじんみんきょうわこくまかおとくべつぎょうせいく	ちゅうかじんみんきょうわこくまかおとくべつぎょうせいく 🇲🇴
らっかせい	らっかせい 🥜
ほこうしゃ	ほこうしゃ 🚶 🚶‍♀️ 🚶‍♀️‍➡️ 🚶‍♂️ 🚶‍♂️‍➡️ 🚶‍➡️
ふとじのちぇっく	ふとじのちぇっく ✔️
おさつ	おさつ 💴 💵 💶 💷 💸
年齢制限	年齢制限 🔞
あふがにすたん	あふがにすたん 🇦🇫
医療のシンボル	医療のシンボル ⚕️
三角定規	三角定規 📐
10じはん	10じはん 🕥️
おさら	おさら 🍽️
すのーぼーだー	すのーぼーだー 🏂️
いやふぉん	いやふぉん 🎧️
しょせき	しょせき 📕 📖 📗 📘 📙 📚️
えぬじー	えぬじー 🆖 👎️ 🙅 🙅‍♀️ 🙅‍♂️
れんが	れんが 🧱 🧱
じょうききかんしゃ	じょうききかんしゃ 🚂
ぴっつぁ	ぴっつぁ 🍕
鶏もも肉	鶏もも肉 🍗
でぃえごがるしあとう	でぃえごがるしあとう 🇩🇬
熱	熱 😳 🦟
ぼーとをこぐおとこ	ぼーとをこぐおとこ 🚣‍♂️
じょっき	じょっき 🍺 🍻
きこうへんどう	きこうへんどう 🪸
5時	5時 🕔️
目覚まし	目覚まし ⏰️
ウインク	ウインク 😉
ぼりびあ	ぼりびあ 🇧🇴
天使	天使 👼 🪽
れんち	れんち 🔧 🛠️
カンボジア	カンボジア 🇰🇭
ビタミン剤	ビタミン剤 💊
べろんべろん	べろんべろん 🥴 🥴
無（無料）	無（無料） 🈚️
賭け金	賭け金 💰️
えいおおもじのにゅうりょく	えいおおもじのにゅうりょく 🔠
ユルト	ユルト 🛖
表情（あちゃー）	表情（あちゃー） 😣
あんぜんべすと	あんぜんべすと 🦺
下向きカーブ矢印	下向きカーブ矢印 ⤵️
ばけつ	ばけつ 🪣 🪣
すとーん	すとーん 🥌
円ドル	円ドル 💱
こどもひとり	こどもひとり 🧑‍🧑‍🧒 🧑‍🧒
裸足	裸足 👣
クリア	クリア 🆑
ビックリ	ビックリ 🫨
礼拝堂	礼拝堂 ⛪️ 💒
くりすますいぶ	くりすますいぶ 🎄
にんぷ	にんぷ 🤰 🫃 🫄
れんぷ	れんぷ 🎵
いとまき	いとまき 🧵
遺灰	遺灰 ⚱️
せきゅりてぃ	せきゅりてぃ 🔐 🪪
優等生	優等生 🤓
キーボード	キーボード ⌨️ 🎹
9:30	9:30 🕤️ 🕤️
複数本	複数本 📚️
キャンドル	キャンドル 🕯️
爪	爪 💅
牌	牌 🀄️
ゴハン１	ゴハン１ 🍴
iまーく	iまーく ℹ️
内向的	内向的 🫥
ひょう	ひょう 🐆
うれしなみだのかお	うれしなみだのかお 🥲
牙	牙 🦣 🧛
こくおう	こくおう 🫅
牛	牛 🐂 🐃 🐄 🐮 🦬
研究	研究 🔬
めをほそめる	めをほそめる 😊
さーびすりょう	さーびすりょう 🈂️
カーカー	カーカー 🐦‍⬛
とけているかお	とけているかお 🫠
橋	橋 🌉
つうがくろ	つうがくろ 🚸
べすと	べすと 🦺
申マーク	申マーク 🈸
錠前	錠前 🔒️
にやりとするねこ	にやりとするねこ 😼
ばいおはざーど	ばいおはざーど ☣️
緊急	緊急 🚨 🦺
しかい	しかい 😷
打ち上げ花火	打ち上げ花火 🎆
こんごみんしゅきょうわこく	こんごみんしゅきょうわこく 🇨🇩
たしざん	たしざん ➕️
武器	武器 ⚔️ 🏹 🔫 🗡️ 🪃
りょうめ	りょうめ 👀
つりざお	つりざお 🎣
びるぐん	びるぐん 🏙️
力こぶ	力こぶ 💪
少年	少年 👦
りょうて	りょうて 🙌 🙏 🤲
しかく	しかく ⏹️ ▪️ ▫️ ◻️ ◼️ ◽️ ◾️ ⬛️ ⬜️ 👨‍🦯 👨‍🦯‍➡️ 👩‍🦯 👩‍🦯‍➡️ 🔲 🔳 🔶 🔷 🔸 🔹 🟥 🟦 🟧 🟨 🟩 🟪 🟫 🦮 🦯 🧑‍🦯 🧑‍🦯‍➡️
しかけ	しかけ 🪤
ふといまる	ふといまる ⭕️
りょうり	りょうり 🍳 👨‍🍳 👩‍🍳 🔪 🧑‍🍳
男性の衛兵	男性の衛兵 💂‍♂️
かけざん	かけざん ✖️ ❌️ ❎️
ココのマーク	ココのマーク 🈁
けいさつ	けいさつ 👮 👮‍♀️ 👮‍♂️ 🚓 🚔️ 🚨
タイマー	タイマー ⌛️ ⏲️ ⏳️
ぱーてぃ	ぱーてぃ 👯
潮吹きクジラ	潮吹きクジラ 🐳
手袋	手袋 🧤
犬	犬 🐕️ 🐕‍🦺 🐩 🐶 🐾 🦮 🦴
狐	狐 🦊
あるふぁべっと	あるふぁべっと 🔠 🔡 🔤
けいさん	けいさん ➖️ 🧮
さんぴえーるとう・みくろんとう	さんぴえーるとう・みくろんとう 🇵🇲
７じ	７じ 🕖️
うたがい	うたがい 🤨
でんどうくるまいす	でんどうくるまいす 🦼
ハチ	ハチ 🐝
ふぉるだー	ふぉるだー 📁 📂 🗂️
重たい	重たい 🪨
ギア	ギア ⚙️
脳みそ	脳みそ 🧠
しょしんしゃ	しょしんしゃ 🔰
ほのお	ほのお ❤️‍🔥 🔥
ハト	ハト 🕊️
ハエ	ハエ 🪰
まんごー	まんごー 🥭
チェーン	チェーン ⛓️ ⛓️‍💥
サウジアラビア	サウジアラビア 🇸🇦
ゆきのけっしょう	ゆきのけっしょう ❄️
トライアスロン	トライアスロン 🏊️
ハグ	ハグ 🤗 🫂
手（チョキ）	手（チョキ） ✌️
ヒツジ	ヒツジ 🐏 🐑
バスケットボールをする女	バスケットボールをする女 ⛹️‍♀️
ぱえりあ	ぱえりあ 🥘
ぽてとふらい	ぽてとふらい 🍟
たぴおかどりんく	たぴおかどりんく 🧋
狼	狼 🐺
えんぜる	えんぜる 👼
配送	配送 📦️ 🚚
しんゆう	しんゆう 👯 👯‍♂️
こすめ	こすめ 💄
ふうとうとやじるし	ふうとうとやじるし 📩
ジョーカー	ジョーカー 🃏
レスリングする男	レスリングする男 🤼‍♂️
次へ	次へ ▶️
エンド	エンド 🔚
さわやか	さわやか 🍋‍🟩 🍋‍🟩
いかり	いかり ⚓️ ⚓️ 👺 💢 🔱 🗯️ 😠 😡 😤 🤬
あつあつ	あつあつ 🍜 👨‍❤️‍👨 👩‍❤️‍👨 👩‍❤️‍👩 💑
6:00	6:00 🕕️ 🕕️
猪	猪 🐗
もんすたー	もんすたー 👾 🧌
猫	猫 🐈️ 🐈‍⬛ 🐱 🐾 😸 😹 😺 😻 😼 😽 😾 😿 🙀
はちじ	はちじ 🕗️
清潔	清潔 🧼
むりょう	むりょう 🆓 🈚️
落葉樹	落葉樹 🌳
一戸建て	一戸建て 🏠️ 🏡
じゃんぷ	じゃんぷ 🦘
らぐびー	らぐびー 🏈 🏉
嬉しい	嬉しい 😆
ぼせき	ぼせき 🪦
さんぱつされるおとこ	さんぱつされるおとこ 💇‍♂️
はっぴー	はっぴー ☺️ 😀 😁 😃 😄 😇 🙂
猿	猿 🐒 🐵 🙈 🙉 🙊 🦧
こき	こき 📞
こぐ	こぐ 🚣
ウンチマーク	ウンチマーク 💩
はもの	はもの 🪒
ここ	ここ 🈁 🈁
ハイキングシューズ	ハイキングシューズ 🥾
玉	玉 🔮
こざ	こざ 🧘
王	王 🫅
1時半	1時半 🕜️
歌	歌 🎤
血液型B型	血液型B型 🅱️
こうそくれっしゃ	こうそくれっしゃ 🚄 🚅
カクテル	カクテル 🍸️ 🍹
配達	配達 📦️ 🚚 🛻
こめ	こめ 🌾 🍙 🍚
半魚人	半魚人 🧜
こや	こや 🛖
ねっとわーく	ねっとわーく 🛜
どせい	どせい 🪐
バンガロー	バンガロー 🛖
わりまーく	わりまーく 🈹
サロン	サロン 💆
2時	2時 🕑️
組み合わせ	組み合わせ 🧩
ブルキナファソ	ブルキナファソ 🇧🇫
神社	神社 ⛩️
砂時計１	砂時計１ ⌛️
砂時計２	砂時計２ ⏳️
カタール	カタール 🇶🇦
こぶ	こぶ 🐪 🐫
ティーポット	ティーポット 🫖
薬草	薬草 🌿 🫚
歯	歯 🦷 🧛
トロフィー	トロフィー 🏆️
くらっちばっぐ	くらっちばっぐ 👝
りょうてのひら	りょうてのひら 👐
手を挙げる男	手を挙げる男 🙋‍♂️
こま	こま ♟️
きんときまめ	きんときまめ 🫘
はろうぃんかぼちゃ	はろうぃんかぼちゃ 🎃
メール送信	メール送信 📩
自然	自然 🌊 🏞️
トカゲ	トカゲ 🦎
ものさし	ものさし 📏 📏
りろーど	りろーど 🔃
うぃんどう	うぃんどう 🪟
死	死 ☠️ ⚰️ ⚱️ 💀
ブロッコリー	ブロッコリー 🥦
球	球 🎳
新芽	新芽 🌱
あばかす	あばかす 🧮
ちょうるい	ちょうるい 🐦‍⬛ 🪿
葬儀	葬儀 ⚱️
ランプをこする	ランプをこする 🧞
AB	AB 🆎
6:30	6:30 🕡️ 🕡️
ひとのしるえっと	ひとのしるえっと 👤
いすらむきょう	いすらむきょう ☪️ 🕋 🕌
礼拝所	礼拝所 🛐
えいこもじのにゅうりょく	えいこもじのにゅうりょく 🔡
すこしこまった	すこしこまった 🙁
たべもの	たべもの 🥭 🫐 🫑 🫒 🫓 🫔 🫕 🫘
やぎ座	やぎ座 ♑️ 🐐
毒	毒 🍄 🐍 🪼
いせいじん	いせいじん 👽️ 👾
おおきいあおのひしがた	おおきいあおのひしがた 🔷
せーりんぐ	せーりんぐ ⛵️
アイスホッケー	アイスホッケー 🏒
ざせき	ざせき 💺
ちょうりきぐ	ちょうりきぐ 🔪
くらい	くらい 🔅
女性と男の子の家族	女性と男の子の家族 👩‍👦
音量小	音量小 🔉
かぜぐすり	かぜぐすり 💊
ヌードル	ヌードル 🍜
×	× ❌️
やさい	やさい 🌰 🌶️ 🌽 🍄 🍅 🍆 🍈 🍉 🥑 🥒 🥔 🥕 🥜 🥦 🧄 🧅 🫑 🫛
もーたーぼーと	もーたーぼーと 🚤 🛥️
あいすくりーむ	あいすくりーむ 🍨
くらげ	くらげ 🪼
ふくれっ面	ふくれっ面 😡
目がまわる時の記号	目がまわる時の記号 💫
上を見る顔	上を見る顔 🙄
国旗（イギリス）	国旗（イギリス） 🇬🇧
えいへい	えいへい 💂 💂‍♀️ 💂‍♂️
繰り返し	繰り返し 🔁 🔂 🔄
ストロベリー	ストロベリー 🍓
直翅目	直翅目 🦗
男性と男の子と男の子の家族	男性と男の子と男の子の家族 👨‍👦‍👦
びーんず	びーんず 🫘
稲穂	稲穂 🌾
受信箱	受信箱 📥️ 📨
きたまりあなしょとう	きたまりあなしょとう 🇲🇵
たてもの	たてもの ⛩️ ⛪️ 🏚️ 🏠️ 🏡 🏢 🏣 🏤 🏥 🏦 🏨 🏩 🏪 🏫 🏬 🏭️ 🏯 🏰 💒 🕋 🕌 🕍 🛕
映画カメラ	映画カメラ 🎥
だんせいとだんせいとおんなのことおんなのこのかぞく	だんせいとだんせいとおんなのことおんなのこのかぞく 👨‍👨‍👧‍👧
スケボー	スケボー 🛹
さいばんかん	さいばんかん 👨‍⚖️ 👩‍⚖️ 🧑‍⚖️
身分証明書	身分証明書 🪪
レユニオン	レユニオン 🇷🇪
ちゅうかぼうのだんせい	ちゅうかぼうのだんせい 👲
とじたじょうとぺん	とじたじょうとぺん 🔏
くらぶ	くらぶ ♣️ 🍸️
CD	CD 💿️ 📀
かぶか	かぶか 💹
ニワトリ	ニワトリ 🐓 🐔
だんせいとおんなのこのかぞく	だんせいとおんなのこのかぞく 👨‍👧
寝顔	寝顔 😴
CL	CL 🆑
水	水 💧 🚰 🥤 🫗
トロピカルドリンク	トロピカルドリンク 🍹
汗	汗 💦 💧 😅 😓 😥 😰 🥵
氷	氷 🍧 🧊
びじねすぱーそん	びじねすぱーそん 👨‍💼 👩‍💼 🧑‍💼
とけそう	とけそう 🫠
４じ	４じ 🕓️
11じ30ふん	11じ30ふん 🕦️
ゴースト	ゴースト 👻
やきゅうぼう	やきゅうぼう 🧢
有料	有料 🈶 💴
ぺろぺろキャンディ	ぺろぺろキャンディ 🍭
シャワー	シャワー 🚿
だんせいとじょせいとおとこのことおとこのこのかぞく	だんせいとじょせいとおとこのことおとこのこのかぞく 👨‍👩‍👦‍👦
グラフ１（折れ線グラフ）	グラフ１（折れ線グラフ） 📈
なげきっす	なげきっす 😘
やまをのぼるおんな	やまをのぼるおんな 🧗‍♀️
泳ぐ男	泳ぐ男 🏊‍♂️
カニ	カニ 🦀
星座（かに座）	星座（かに座） ♋️
とざんてつどう	とざんてつどう 🚞
9じ	9じ 🕘️
カキ	カキ 🦪
乙女座	乙女座 ♍️
カバ	カバ 🦛
まるいえむまーく	まるいえむまーく Ⓜ️
環	環 🔗
女性と女の子の家族	女性と女の子の家族 👩‍👧
セーリング	セーリング ⛵️
ボーリング	ボーリング 🎳
かんばん	かんばん 🪧
メカニック	メカニック 👨‍🔧 👩‍🔧 🧑‍🔧 🧰
噴火	噴火 🌋
アメフト	アメフト 🏈
コーヒー	コーヒー ☕️
かみなり	かみなり ⚡️ ⛈️ 🌩️
こぴーらいと	こぴーらいと ©️
カメ	カメ 🐢
カモ	カモ 🦆
がっき	がっき 🎷 🎸 🎹 🎺 🎻 🥁 🪇 🪈 🪉 🪕 🪗 🪘
セクシー	セクシー 💋 🫦
時計回り	時計回り 🔁 🔂 🔃
復活	復活 🐦‍🔥
うごくめだま	うごくめだま 👀
アクセシビリティ	アクセシビリティ 🐕‍🦺 👨‍🦯 👨‍🦯‍➡️ 👨‍🦼 👨‍🦼‍➡️ 👨‍🦽 👨‍🦽‍➡️ 👩‍🦯 👩‍🦯‍➡️ 👩‍🦼 👩‍🦼‍➡️ 👩‍🦽 👩‍🦽‍➡️ 🛗 🦮 🦯 🦻 🦼 🦽 🦾 🦿 🧏 🧏‍♀️ 🧏‍♂️ 🧑‍🦯 🧑‍🦯‍➡️ 🧑‍🦼 🧑‍🦼‍➡️ 🧑‍🦽 🧑‍🦽‍➡️
えいりあん	えいりあん 👽️ 👾
映画	映画 🎞️ 🎥 🎦 🎬️ 📽️
とれい	とれい 📤️ 📥️
まぬけ	まぬけ 🪿 🪿
ブーメラン	ブーメラン 🪃
すりなむ	すりなむ 🇸🇷
やきいも	やきいも 🍠 🍠
友情	友情 👭 🫂
3:00	3:00 🕒️ 🕒️
女性と男性のカップル	女性と男性のカップル 👩‍❤️‍👨
瓶	瓶 🫙
ゆうりょう	ゆうりょう 🈶 💴
たーばんのじょせい	たーばんのじょせい 👳‍♀️
F1	F1 🏎️
なみだ	なみだ 💧 😂 😢 😭 😹 😿 🤣 🥲 🥹
まーじゃん	まーじゃん 🀄️
じゅうじか	じゅうじか ☦️ ⛪️ ✝️
ひなにんぎょう	ひなにんぎょう 🎎
ロボット	ロボット 🤖
泡	泡 🍾 🧼 🫧
ぎじゅつしゃ	ぎじゅつしゃ 🧑‍💻
波	波 〰️ 🌊 🏄️
珊瑚礁	珊瑚礁 🪸
けつえき	けつえき 🩸
忍者	忍者 🥷
ろぼっとのかお	ろぼっとのかお 🤖
換気	換気 🪟
さいりよう	さいりよう ♻️
ふぃりぴん	ふぃりぴん 🇵🇭
ノルウェー	ノルウェー 🇳🇴
FD	FD 💾
はくじょうをついたじょせい	はくじょうをついたじょせい 👩‍🦯 👩‍🦯‍➡️
顔のある満月	顔のある満月 🌝
暗い	暗い 🔅
しぇいかー	しぇいかー 🪇
旗（祝日・日の丸）	旗（祝日・日の丸） 🇯🇵
魔力	魔力 🧝
申	申 🈸
男性歌手	男性歌手 👨‍🎤
そーいんぐ	そーいんぐ 🧵
ここすしょとう	ここすしょとう 🇨🇨
こいんろっかー	こいんろっかー 🛅
方角	方角 🧭
男	男 ♂️ 🏄‍♂️ 🏋️‍♂️ 🏌️‍♂️ 👨 👨‍⚕️ 👨‍⚖️ 👨‍✈️ 👨‍🌾 👨‍🍳 👨‍🍼 👨‍🎓 👨‍🎤 👨‍🎨 👨‍🏫 👨‍🏭 👨‍💻 👨‍🔧 👨‍🔬 👨‍🚀 👨‍🚒 👨‍🦰 👨‍🦱 👨‍🦲 👨‍🦳 👫 👬 👯‍♂️ 👰‍♂️ 👱‍♂️ 👲 👳‍♂️ 👷‍♂️ 💁‍♂️ 💆‍♂️ 💇‍♂️ 🕴️ 🕵️ 🕵️‍♂️ 🕺 🙅‍♂️ 🙆‍♂️ 🙇‍♂️ 🙋‍♂️ 🙍‍♂️ 🙎‍♂️ 🚵‍♂️ 🤦‍♂️ 🤴 🤵‍♂️ 🤷‍♂️ 🤾‍♂️ 🧔‍♂️ 🧖‍♂️ 🧗‍♂️ 🧘‍♂️ 🧙‍♂️ 🧚‍♂️ 🧛‍♂️ 🧜‍♂️ 🧝‍♂️ 🧞‍♂️ 🧟‍♂️ 🫃
ふぇいすまっさーじちゅうのひと	ふぇいすまっさーじちゅうのひと 💆
ヨット	ヨット ⛵️
しんとまーるてん	しんとまーるてん 🇸🇽
キュラソー	キュラソー 🇨🇼
ダッシュ	ダッシュ 💨
チャペル	チャペル ⛪️ 💒 🔔
点線の顔	点線の顔 🫥
はいきんぐ	はいきんぐ 🚶 🚶‍♀️ 🚶‍♀️‍➡️ 🚶‍➡️ 🥾
小型バス	小型バス 🚐
せらぴすと	せらぴすと 👨‍⚕️ 👩‍⚕️ 🧑‍⚕️
がーがー	がーがー 🪿
ドキドキしているハート	ドキドキしているハート 💓
くものす	くものす 🕸️
さーふぃん	さーふぃん 🏄️
名刺ホルダー	名刺ホルダー 📇
きっくすくーたー	きっくすくーたー 🛴
ぶーめらん	ぶーめらん 🪃
サリー	サリー 🥻
ふくすうのおんぷ	ふくすうのおんぷ 🎶
じゅーす	じゅーす 🥤 🧃
すまいる	すまいる ☺️ 😀 😁 😂 😃 😄 😅 😆 😇 😈 😊 😋 😍 😎 😙 😸 😹 😺 😻 🙂 🤗 🤣 🤩 🤭
中国国旗	中国国旗 🇨🇳
マヨット	マヨット 🇾🇹
ちゅうしゃ	ちゅうしゃ 🅿️ 💉
なぞのひと	なぞのひと 👤
日本酒	日本酒 🍶
遊び好き	遊び好き 🦦
太字の等号	太字の等号 🟰
びっくりマーク（アニメ）	びっくりマーク（アニメ） ❕️
くさのもの	くさのもの 🥷
れーしんぐかー	れーしんぐかー 🏎️
コオロギ	コオロギ 🦗
せいざするだんせい	せいざするだんせい 🧎‍♂️ 🧎‍♂️‍➡️
息切れ	息切れ 😮‍💨
手を叩く	手を叩く 👏
フック	フック 🪝
3:30	3:30 🕞️ 🕞️
バス乗り場	バス乗り場 🚏
がびょう	がびょう 📌 📌 📍
ぎんめだる	ぎんめだる 🥈
海	海 🌊 🏄️ 🔱 🪸 🪼
涙	涙 💧 😂 😢 😭 😹 😿 🤣 🥲 🥹
しらない	しらない 🤷 🤷‍♀️ 🤷‍♂️
レズビアン	レズビアン 🌈 🏳️‍🌈
ドリブル	ドリブル ⛹️ ⛹️‍♀️
たんにん	たんにん 🧑‍🏫
ねまちづき	ねまちづき 🌖
ID	ID 🆔 🪪
石けん	石けん 🧼 🫧
くるぶし	くるぶし 🦶 🦶
魚介	魚介 🦪
男性と女性と女の子の家族	男性と女性と女の子の家族 👨‍👩‍👧
2じ30ふん	2じ30ふん 🕝️
南アフリカ	南アフリカ 🇿🇦
ソーイング	ソーイング 🧵
涙をこらえた顔	涙をこらえた顔 🥹
あれぱ	あれぱ 🫓
ぐー	ぐー ✊️ 👊
水中	水中 🫧
チェッカーフラグ	チェッカーフラグ 🏁
固定電話	固定電話 ☎️
釣り竿	釣り竿 🎣
みずぎ	みずぎ 👙 🩱 🩲 🩳
マニア	マニア 🤓
ガソリンスタンド	ガソリンスタンド ⛽️
済	済 ☑️ ✅️ ✔️
早戻しボタン	早戻しボタン ⏪️
ひだり	ひだり ↩️ ⏪️ ⬅️ 👈️ 🤛
どらごん	どらごん 🐉 🐲
はなすひとのしるえっと	はなすひとのしるえっと 🗣️
手がかり	手がかり 🗝️
おれんじ	おれんじ 🍊 🔶 🔸 🟠 🟧 🧡
お団子	お団子 🍡
じょせいかいしゃいん	じょせいかいしゃいん 👩‍💼
ゴミ捨て禁止	ゴミ捨て禁止 🚯
まんねんひつ	まんねんひつ ✒️ 🖋️
さいたはな	さいたはな 🌼
ほろよい	ほろよい 🥴
7時30分	7時30分 🕢️
11時	11時 🕚️
ものれーる	ものれーる 🚈 🚝 🚟
的	的 🎯
懐中電灯	懐中電灯 🔦
１じ	１じ 🕐️
うんうん	うんうん 🙂‍↕️ 🙂‍↕️
頭爆発	頭爆発 🤯
死者	死者 ⚰️ 💀
ドア	ドア 🚪
ｅメールアイコン	ｅメールアイコン 📧
オイスター	オイスター 🦪
ムキムキ	ムキムキ 💪
あいすすけーと	あいすすけーと ⛸️
悪臭	悪臭 🦨
空室・空席・空車	空室・空席・空車 🈳
じゅういちじ	じゅういちじ 🕚️
吹き出しコメント	吹き出しコメント 💬
6じ	6じ 🕕️
ミヤマガラス	ミヤマガラス 🐦‍⬛
ここす(きーりんぐ)しょとう	ここす(きーりんぐ)しょとう 🇨🇨
はーとがたのて	はーとがたのて 🫶
エビ	エビ 🍤 🦐
白	白 ▫️ ◻️ ◽️ ⚪️ ⬜️ 🏳️ 🐻‍❄️ 🤍
テレビ	テレビ 📺️
信号縦	信号縦 🚦
こーすたー	こーすたー 🎢
衛生	衛生 🪥
ふつりょうきょくなんしょとう	ふつりょうきょくなんしょとう 🇹🇫
手（ブーイング）	手（ブーイング） 👎️
びきに	びきに 👙
りょかくせん	りょかくせん 🛳️
あしあと	あしあと 🐾 👣
１０じ	１０じ 🕙️
おことわり	おことわり 🙅
ドル	ドル 💰️ 💱 💲 💵 💸
ぱらそる	ぱらそる ⛱️ 🏖️
じゅうたくがい	じゅうたくがい 🏘️
赤い上三角	赤い上三角 🔺
打楽器	打楽器 🪇
だいびんぐますく	だいびんぐますく 🤿
六角星	六角星 🔯
ポスト	ポスト 📪️ 📫️ 📬️ 📭️ 📮
ブロントサウルス	ブロントサウルス 🦕
皿	皿 🍽️
鍵（ロック）	鍵（ロック） 🔒️
ベビーマーク	ベビーマーク 🚼️
茶色の丸	茶色の丸 🟤
はーとまーく	はーとまーく ❤️
かぶとむし	かぶとむし 🪲
MD	MD 💽
熱がある顔	熱がある顔 🤒
オーストリア	オーストリア 🇦🇹
らいらっく	らいらっく 🪻
目	目 👀 👁️ 👁️‍🗨️ 👨‍🦯 👨‍🦯‍➡️ 👩‍🦯 👩‍🦯‍➡️ 🧑‍🦯 🧑‍🦯‍➡️ 🪬
おねがい	おねがい 🙇 🙏 🥺
ブルンジ	ブルンジ 🇧🇮
かくてるぐらす	かくてるぐらす 🍸️
なざーる	なざーる 🧿
すずむ	すずむ 🪭
許して	許して 🙇
辛い	辛い 🌶️
ちゃいろいはーと	ちゃいろいはーと 🤎
きく	きく 👂️
MO	MO 💽
画鋲	画鋲 📌
あめときどきはれ	あめときどきはれ 🌦️
天使の輪がついた笑顔	天使の輪がついた笑顔 😇
ほうよう	ほうよう 🫂
盾	盾 🛡️
らとる	らとる 🪇
きす	きす 👄 👨‍❤️‍💋‍👨 👩‍❤️‍💋‍👨 👩‍❤️‍💋‍👩 💋 💏 😗 😘 😙 😚 😽
えのぐ	えのぐ 🖌️
きず	きず 🩹
右側	右側 🫱
電池切れ寸前	電池切れ寸前 🪫
さよなら	さよなら 👋
きた	きた ⬆️
廃屋	廃屋 🏚️
まうんてんばいくにのるおとこ	まうんてんばいくにのるおとこ 🚵‍♂️
さとう	さとう 🧁
したむき	したむき 📉
電動車椅子の女性	電動車椅子の女性 👩‍🦼 👩‍🦼‍➡️
NG	NG 🆖 👎️ 🙅 🙅‍♀️ 🙅‍♂️
表示（冷笑）	表示（冷笑） 😏
赤茶	赤茶 🦰
つかれた	つかれた 😪 😫 😮‍💨 😵 🫩
じょせいのまーく	じょせいのまーく ♀️
タンザニア	タンザニア 🇹🇿
きり	きり 🌁 🌫️
ホッキョクグマ	ホッキョクグマ 🐻‍❄️
きど	きど 🔅 🔆
きる	きる ✂️ 🪚
顔のある太陽	顔のある太陽 🌞
くりけっと	くりけっと 🏏
算盤	算盤 🧮
ちゅうごく	ちゅうごく 🇨🇳
ホテル	ホテル 🏨 🏩 🛋️ 🛌 🛎️ 🛏️
のぞきみ	のぞきみ 🫣
ないじぇりあ	ないじぇりあ 🇳🇬
きば	きば 🦣 🧛
パトカーのランプ	パトカーのランプ 🚨
くびをふる	くびをふる 🙂‍↔️ 🙂‍↕️
きん	きん 🈲 🏅 🥇
図書館	図書館 📖 📗 📘 📙
ねりもの	ねりもの 🍢 🍥
ちゅうしゃじょう	ちゅうしゃじょう 🅿️
ほらー	ほらー 🧟 🧟‍♀️ 🧟‍♂️
さらだ	さらだ 🥗 🥬
中央アフリカ共和国	中央アフリカ共和国 🇨🇫
たんとう	たんとう 🗡️
授乳する男性	授乳する男性 👨‍🍼
メモする	メモする 📝
目覚まし時計	目覚まし時計 ⏰️
くつろぎ	くつろぎ 🧘 🧘
くつろぐ	くつろぐ 🧖 🧖
クマの顔	クマの顔 🐻
１８禁	１８禁 🔞
OK	OK 🆗 👌 👍️ 🙆 🙆‍♂️
OL	OL 👩‍💼
じゅうじ	じゅうじ 🕙️
ON	ON 🔛
婦人帽子	婦人帽子 👒
がま口	がま口 👛
ゆーれい	ゆーれい 👻
きょくせん	きょくせん ↩️ ↪️ ⤴️ ⤵️
じゅえりー	じゅえりー 💍 💎
PC	PC ⌨️ 💻️ 🖥️ 🖱️ 🖲️
はねがはえたおかね	はねがはえたおかね 💸
ごしっぷ	ごしっぷ 💁
しゅくはい	しゅくはい 🥂
12:00	12:00 🕛️ 🕛️
おーばー	おーばー 🧥
じどり	じどり 🤳
じょうげんのつき	じょうげんのつき 🌓 🌛
しょっぴんぐばっぐ	しょっぴんぐばっぐ 🛍️
しーるど	しーるど 🛡️
携帯禁止	携帯禁止 📵
だんせいのけんせつさぎょういん	だんせいのけんせつさぎょういん 👷‍♂️
口に手を当てた顔	口に手を当てた顔 🤭
砂	砂 ⌛️ ⏳️
矢	矢 🏹 💘
じーんず	じーんず 👖
がく～（落胆した顔）	がく～（落胆した顔） 😞
きー	きー 🔐 🔑 🗝️
いんふぉめーしょんしんぼる	いんふぉめーしょんしんぼる ℹ️
ハンマーとつるはし	ハンマーとつるはし ⚒️
海賊	海賊 🏴‍☠️ 🦜
でぱーと	でぱーと 🏬
せつぞく	せつぞく 🛜
石	石 🪨
しあい	しあい 🥌
ばーれーん	ばーれーん 🇧🇭
耳	耳 👂️ 🦻
無表情	無表情 😐️ 😑 😶
りょこうかばん	りょこうかばん 🧳
こうでんあつ	こうでんあつ ⚡️
ぷーさん	ぷーさん 🍯
ぴんひーる	ぴんひーる 👠
クレヨン	クレヨン 🖍️
かけきん	かけきん 💰️ 🪝
わらぶき小屋	わらぶき小屋 🛖
ばーさす	ばーさす 🆚
肉	肉 🍖 🍗 🥓 🥩
ムスリム	ムスリム ☪️
むらさきのはーと	むらさきのはーと 💜 💟
ざりがに	ざりがに 🦞
きかざる	きかざる 🙉
3い	3い 🥉
かいているて	かいているて ✍️
やくみ	やくみ 🧂 🧄 🧅 🫚
さいれん	さいれん 🚨 🧜
よるのとかい	よるのとかい 🌃
11時30分	11時30分 🕦️
ろしあ	ろしあ 🇷🇺 🪆
イチゴ	イチゴ 🍓
あるくしかばね	あるくしかばね 🧟
上弦の月	上弦の月 🌓 🌛
まいなすどらいばー	まいなすどらいばー 🪛
火の鳥	火の鳥 🐦‍🔥
ひのとり	ひのとり 🐦‍🔥
アウトドア	アウトドア 🥾
紋章	紋章 ⚜️
さんがく	さんがく ⛰️
ばすけっとぼーるせんしゅ	ばすけっとぼーるせんしゅ ⛹️
砂浜	砂浜 ⛱️ 🏖️
セリフ	セリフ 💬 🗨️
3じ	3じ 🕒️
しあん	しあん 🩵
あっかんべー	あっかんべー 😜 😜
碇	碇 ⚓️
たっきゅう	たっきゅう 🏓
かばん	かばん 🎒 👜 👜 💼 💼
封筒２	封筒２ 📨
北朝鮮	北朝鮮 🇰🇵
18さいみまんきんし	18さいみまんきんし 🔞
ろめんでんしゃ	ろめんでんしゃ 🚊 🚋 🚎
ねこのきす	ねこのきす 😽
12:30	12:30 🕧️ 🕧️
ゴメン／お願い	ゴメン／お願い 🙏
やまあらし	やまあらし 🦔
ミツアナグマ	ミツアナグマ 🦡
SL	SL 🚂
ここなつ	ここなつ 🥥
血液型AB型	血液型AB型 🆎
両手ハート	両手ハート 🫶
肺	肺 🫁
トイレットペーパー	トイレットペーパー 🧻
かうぼーいのかお	かうぼーいのかお 🤠
めもちょう	めもちょう 🗒️
ふぃるむ	ふぃるむ 🎞️ 🎥 📽️
ガボン	ガボン 🇬🇦
きりすときょう	きりすときょう ☦️ ⛪️ ✝️
脈	脈 🫀
ようなし	ようなし 🍐
枝角	枝角 🫎
おーむ	おーむ 🕉️
TG	TG ⚧️ 🏳️‍⚧️
たつまき	たつまき 🌪️
リピート	リピート 🔁 🔂 🔄
はくじゅうじへるめっと	はくじゅうじへるめっと ⛑️
魔法使い	魔法使い 🧙 🧙‍♀️ 🧙‍♂️
早戻し	早戻し ⏪️
すかいだいびんぐ	すかいだいびんぐ 🪂
おう	おう 🫅
だんせいとだんせいとおとこのことおとこのこのかぞく	だんせいとだんせいとおとこのことおとこのこのかぞく 👨‍👨‍👦‍👦
おーる	おーる 👩‍💼 🚣
げっそり	げっそり 😱
中四角１	中四角１ ◽️
子供の日	子供の日 🎏
脚	脚 🦵 🦿
中四角２	中四角２ ◾️
トンボ返り	トンボ返り 🤸 🤸‍♀️ 🤸‍♂️
りさいくるまーく	りさいくるまーく ♻️
ウサギ	ウサギ 🐇 🐰
きゅういんかっぷ	きゅういんかっぷ 🪠
TV	TV 📺️
メノーラー	メノーラー 🕎
グッド（上向き矢印）	グッド（上向き矢印） ⤴️
モンスター	モンスター 👾 🧌
おけ	おけ 🪣 🪣
暑い	暑い 🫠
アルファベット	アルファベット 🔠 🔡 🔤
噴水	噴水 ⛲️
だんせいとだんせいできす	だんせいとだんせいできす 👨‍❤️‍💋‍👨
おとなし	おとなし 🔇 🔕
おす	おす 🫷 🫸
慰め	慰め 🫂
よだれを垂らした顔	よだれを垂らした顔 🤤
キャビネット	キャビネット 🗄️
聴診器	聴診器 🩺
ねいる	ねいる 💅
ミニバス	ミニバス 🚐
脳	脳 🧠
こんびに	こんびに 🏪
はんどばっぐ	はんどばっぐ 👜 👝
さゆう	さゆう ↔️
しょくじ	しょくじ 🍴
腕	腕 💪 🦾
暑さ	暑さ 🥵
うぃんく	うぃんく 😉 😜
UP	UP 🆙
バクテリア	バクテリア 🦠 🧫
えちおぴあ	えちおぴあ 🇪🇹
おに	おに 👹
おの	おの 🪓 🪓
ボールペン	ボールペン 🖊️
釣り	釣り 🎣 🐟️
虫眼鏡左	虫眼鏡左 🔍️
エキスパート	エキスパート 🤓
おん	おん 🔛
オランダ	オランダ 🇳🇱
おふ	おふ 📴
包帯を巻いたハート	包帯を巻いたハート ❤️‍🩹
記号の入力	記号の入力 🔣
おとぎばなし	おとぎばなし 🧌 🧚 🧜
申し込み	申し込み 🈸
虫歯	虫歯 🍬 🪥
交差	交差 🔀
どげざ	どげざ 🙇 🙇‍♀️ 🙇‍♂️
セネガル	セネガル 🇸🇳
やまからひので	やまからひので 🌄
きおん	きおん 🌡️
じょい	じょい 👩‍⚕️
じょう	じょう 🔐 🔒️ 🔓️
トップ	トップ 🔝
膝	膝 🦵
祝	祝 ㊗️
ぼうりんぐ	ぼうりんぐ 🎳
ヘッドフォン	ヘッドフォン 🎧️
禁	禁 🈲
すくりゅーどらいばー	すくりゅーどらいばー 🪛
禅	禅 🧘
飲めない水	飲めない水 🚱
安全ピン	安全ピン 🧷
トケラウ	トケラウ 🇹🇰
紫のハート	紫のハート 💜 💟
じょし	じょし 🚺️
WC	WC 🚹️ 🚹️ 🚺️ 🚺️ 🚻 🚻 🚾 🚾
上半身	上半身 👤 👥
護符	護符 🪬
身分証	身分証 🪪
お金の顔	お金の顔 🤑
くろいまる	くろいまる ⚫️
はぶらし	はぶらし 🪥
おんせんまーく	おんせんまーく ♨️
じょせいとおとこのこのかぞく	じょせいとおとこのこのかぞく 👩‍👦
望遠鏡	望遠鏡 🔭
ふきげんなねこ	ふきげんなねこ 😾
にゅーじーらんど	にゅーじーらんど 🇳🇿
終了	終了 📲
めがぐるぐる	めがぐるぐる 😵‍💫
香辛料	香辛料 🌶️
邪視	邪視 🧿
いんようきんし	いんようきんし 🚱
おとこのぞんび	おとこのぞんび 🧟‍♂️
蜂蜜ポット	蜂蜜ポット 🍯
秋	秋 🥮
舌	舌 👅 😛 😜 😝 🤑
しょうぼうしゃ	しょうぼうしゃ 🚒
へびつかい座	へびつかい座 ⛎️ 🐍
にほんしゅ	にほんしゅ 🍶
らくようじゅ	らくようじゅ 🌳
魔人	魔人 🧞
ちょうちん	ちょうちん 🏮 🏮
黒いハート	黒いハート 🖤
混乱	混乱 😕 😖
蒸留器	蒸留器 ⚗️
秘	秘 ㊙️
しんごうよこ	しんごうよこ 🚥
はーとのびっくり	はーとのびっくり ❣️
ゴンドラ	ゴンドラ 🚠 🚡
有マーク	有マーク 🈶
すきんへっど	すきんへっど 🦲
あめりかがっしゅうこく	あめりかがっしゅうこく 🇺🇸
女性と男性でキス	女性と男性でキス 👩‍❤️‍💋‍👨
輝く星	輝く星 🌟
8じはん	8じはん 🕣️
子供二人	子供二人 🧑‍🧑‍🧒‍🧒 🧑‍🧒‍🧒
受信トレイ	受信トレイ 📥️
マイク	マイク 🎙️ 🎤
史跡	史跡 🏛️
ひげそり	ひげそり 🪒 🪒
わらい	わらい 😁 😂
スペイン国旗	スペイン国旗 🇪🇸
まよっと	まよっと 🇾🇹
わらう	わらう 😀 😁 😂 😸 🤣
考える顔	考える顔 🤔
クロコダイル	クロコダイル 🐊
黄色い四角	黄色い四角 🟨
ばどみんとん	ばどみんとん 🏸
たくしーしょうめん	たくしーしょうめん 🚖
踊る男	踊る男 🕺
船	船 ⚓️ ⛴️ ⛵️ 🚢 🚣 🚣‍♀️ 🚣‍♂️ 🚤 🛥️ 🛳️ 🛶
パラボラアンテナ	パラボラアンテナ 📡
カワウソ	カワウソ 🦦
神道	神道 ⛩️
はんばーがー	はんばーがー 🍔
くりすますつりー	くりすますつりー 🎄
カレー	カレー 🍛
録画	録画 ⏺️ 📹️
砂漠	砂漠 🌵 🏜️ 🐪 🐫
号泣する顔	号泣する顔 😭
むかんしん	むかんしん 🫤
閉じた	閉じた 📪️ 📫️
あかるい	あかるい 🔆
あかりんご	あかりんご 🍎
左向き三角１	左向き三角１ ◀️
芋	芋 🍠
左向き三角２	左向き三角２ ⏪️
ばーげん	ばーげん 🉐
上に向けた手	上に向けた手 🫴
あんしん	あんしん 😌 😮‍💨
猫2	猫2 😏
いんよう	いんよう ☯️
ばっふぁろー	ばっふぁろー 🐃 🦬
ゴールネット	ゴールネット 🥅
ザ・マーク	ザ・マーク 🈂️
ハリケーン	ハリケーン 🌀
ふせん	ふせん 📑 📑 🔖
ぬーどる	ぬーどる 🍜
チョッキ	チョッキ 🦺
稲	稲 🌾
あかるさ	あかるさ 🔅 🔆
毛がない	毛がない 🦲
氷山	氷山 🧊
編み物	編み物 🧶
ハロー	ハロー 👋
初心者	初心者 🔰
植木鉢	植木鉢 🪴
口紅	口紅 💄
入れ子	入れ子 🪆
ゴーグル	ゴーグル 🥽
地図	地図 📍 🗺️ 🗾
子午線のある地球	子午線のある地球 🌐
アリ	アリ 🐜
音符（楽しい）	音符（楽しい） 🎶
おとめ座	おとめ座 ♍️
ふうとう	ふうとう ✉️ 💌 📧 📨
花	花 🌷 🌸 🌹 🌺 🌻 🌼 🏵️ 💐 💮 🥀 🪷 🪻
窓	窓 🪟
オイル	オイル 🛢️ 🪔
穴	穴 🕳️ 🪏
苗	苗 🪴
おうぎ	おうぎ 🪭
おうけ	おうけ 🫅
落花生	落花生 🥜
空	空 🈳 🪽 🫙
しるくはっと	しるくはっと 🎩
りよういん	りよういん 💇 💇‍♂️ 💈
男の吸血鬼	男の吸血鬼 🧛‍♂️
活発	活発 🤸 🤸‍♀️ 🤸‍♂️
芽	芽 🌱
まった	まった 🫷 🫸
おうし	おうし 🐂
おうじ	おうじ 🤴
てをふる	てをふる 👋
ソーダ	ソーダ 🥤
むせんらん	むせんらん 🛜
おっけー	おっけー 🆗 👌 👍️ 🙆‍♀️ 🙆‍♂️
じょせいとおんなのこのかぞく	じょせいとおんなのこのかぞく 👩‍👧
おうむ	おうむ 🦜
フェリー	フェリー ⛴️
ハンドボール	ハンドボール 🤾 🤾‍♀️ 🤾‍♂️
スクロール	スクロール 📜
あいすほっけー	あいすほっけー 🏒
マルガリータ	マルガリータ 🍋‍🟩
Ｏ型	Ｏ型 🅾️
かみてさげ	かみてさげ 🛍️
あごひげ	あごひげ 🧔 🧔 🧔‍♀️ 🧔‍♀️ 🧔‍♂️ 🧔‍♂️
マーク	マーク 📑
ろうじん	ろうじん 👴 👵 🦳 🧓
まっぷ	まっぷ 🗺️
全曲	全曲 🔁
ひがしてぃもーる	ひがしてぃもーる 🇹🇱
苺	苺 🍓
竜	竜 🐉 🐲
おうひ	おうひ 👸
ソープ	ソープ 🧼
はさみ	はさみ ✂️ ✂️ 🦞 🦞
バニーガール	バニーガール 👯‍♀️
どりんく	どりんく 🧃 🧉 🧋
レモン	レモン 🍋
デビル	デビル 👿 😈
１０	１０ 🔟
ローマ字	ローマ字 🔠 🔡 🔤
ウォッチ	ウォッチ ⌚️
首を横に振る	首を横に振る 🙂‍↔️
おののき	おののき 🫢 🫢
草	草 ☘️ 🌾 🌿 🍀
シェイカー	シェイカー 🪇
ブラジル	ブラジル 🇧🇷
ニジェール	ニジェール 🇳🇪
はむすたーのかお	はむすたーのかお 🐹
つばさ	つばさ 🪽
笑	笑 😆
みるきーうぇい	みるきーうぇい 🌌
Vサイン	Vサイン ✌️
ぶーけ	ぶーけ 💐
にっと	にっと 🧶
時計（５時）	時計（５時） 🕔️
にやり	にやり 😏 😏 😼 😼
茸	茸 🍄‍🟫
おおかみ	おおかみ 🐺 🐺
竹	竹 🎍
笛	笛 🥳 🪈
疲れた	疲れた 😪 😫 😮‍💨 😵 🫩
枝豆	枝豆 🫛
12じ	12じ 🕛️
きゃんでぃ	きゃんでぃ 🍬 🍭
エイリアン	エイリアン 👽️ 👾
つばる	つばる 🇹🇻
死にそう	死にそう 🥵
せんべい	せんべい 🍘 🍘
ぶーつ	ぶーつ 👢 🥾
投げキッス	投げキッス 😘
１００	１００ 💯
無線	無線 🛜
かんがえるかお	かんがえるかお 🤔
どくろ	どくろ ☠️ 💀 💀
めまい	めまい 🌀 🌀 😵 😵 😵‍💫 😵‍💫 🥴 🥴
じゅしんき	じゅしんき 📻️
ちょうぞう	ちょうぞう 🗽
オーム	オーム 🕉️
すぺーど	すぺーど ♠️
ステーション	ステーション 🚉
左回り矢印	左回り矢印 🔄
女性と女性と女の子の家族	女性と女性と女の子の家族 👩‍👩‍👧
mail	mail 📩
オール	オール 🚣
念珠	念珠 📿
バイセクシュアル	バイセクシュアル 🌈 🏳️‍🌈
あかいうえさんかく	あかいうえさんかく 🔺
きゃっする	きゃっする 🏰
式場	式場 💒
麻雀	麻雀 🀄️
ぱなま	ぱなま 🇵🇦
悩む顔	悩む顔 😟
郵便局	郵便局 🏣
ふじんふく	ふじんふく 👚
わるぐち	わるぐち 🤬
みゃんまー	みゃんまー 🇲🇲
だまる	だまる 🙊
リロード	リロード 🔃
ミラー	ミラー 🪞
水瓶座	水瓶座 ♒️
ポテトフライ	ポテトフライ 🍟
空っぽの巣	空っぽの巣 🪹
あごひげのじょせい	あごひげのじょせい 🧔‍♀️
黒枠四角	黒枠四角 🔲
すろっと	すろっと 🎰
けばぶ	けばぶ 🥙
べーるのひと	べーるのひと 👰
カラス	カラス 🐦‍⬛
さつたば	さつたば 💴 💵 💶 💷 💸
あおいはーと	あおいはーと 💙
まめ	まめ 🫘 🫛
まち	まち 🏘️
サ（サービス料）	サ（サービス料） 🈂️
わたりがらす	わたりがらす 🐦‍⬛
かるい	かるい 🪶
まて	まて 🫷 🫸
おじぎするひと	おじぎするひと 🙇
箱	箱 🎁 📤️ 📥️ 📦️ 🗃️ 🧰
まと	まと 🎯
まど	まど 🪟
まり	まり 🇲🇱
まる	まる ⏺️ Ⓜ️ ⚪️ ⚫️ ⭕️ 🔴 🔵 🙆 🙆‍♀️ 🙆‍♂️ 🟠 🟡 🟢 🟣 🟤
にくきゅう	にくきゅう 🐾
ひこうきちゃくりく	ひこうきちゃくりく 🛬
うれしなきするねこ	うれしなきするねこ 😹
葉っぱ	葉っぱ 🍂 🍃
マッサージ	マッサージ 💆 💆‍♀️ 💆‍♂️
とびたつ	とびたつ 🪽
ときどきくもり	ときどきくもり ⛅️
箸	箸 🍜 🥡 🥢
指の間からのぞき見る顔	指の間からのぞき見る顔 🫣
停止ボタン	停止ボタン ⏹️
まん	まん 🈵
18歳未満禁止	18歳未満禁止 🔞
あいるらんど	あいるらんど 🇮🇪
宴会	宴会 🍻
かるさ	かるさ 🪯
飛び散ったペンキ	飛び散ったペンキ 🫟
パッキング	パッキング 🧳
しょうひょう	しょうひょう ™️
ぼうえんきょう	ぼうえんきょう 🔭
ぼたんしきでんわ	ぼたんしきでんわ ☎️
男性の悪役	男性の悪役 🦹‍♂️
きゃべつ	きゃべつ 🥬
葉	葉 ☘️ 🌿 🍀 🍁 🍂 🍃
まま	まま 👩‍🍼
がっしょう	がっしょう 🙏
かなだ	かなだ 🇨🇦
あんごら	あんごら 🇦🇴
でんき	でんき ⚡️ 🔌
おてあげするおんな	おてあげするおんな 🤷‍♀️
ぎにあ	ぎにあ 🇬🇳
ものくるをつけたかお	ものくるをつけたかお 🧐
荒波	荒波 🌊
黄ハート	黄ハート 💛
安心	安心 😌 😮‍💨
メッカ	メッカ 🕋
ぜつめつ	ぜつめつ 🦣 🦤
たまれす	たまれす 🫔
嘘つき	嘘つき 🤥
つるはし	つるはし ⚒️ ⚒️ ⛏️ ⛏️
しゅうしんちゅう	しゅうしんちゅう 💤 🛌
熱中症	熱中症 🥵
ぱきすたん	ぱきすたん 🇵🇰
イタリア国旗	イタリア国旗 🇮🇹
自撮り	自撮り 🤳
ピエロ	ピエロ 🤡
でんち	でんち 🔋
笑えない	笑えない 😐️
紅茶	紅茶 ☕️
むしば	むしば 🍬 🪥
赤い箱	赤い箱 🧰
ぴかぴか（新しい）	ぴかぴか（新しい） ✨️
いーめーる	いーめーる ✉️ 📤️ 📥️ 📧 📨 📩
ふじみ	ふじみ 🧛
だいあ	だいあ ♦️ 💍 💎 💠 🔶 🔷 🔸 🔹
ab	ab 🆎
魔女	魔女 🧙 🧙‍♀️ 🧹
でんわ	でんわ ☎️ 📞 📠 📲 🤙
フラッシュを焚いているカメラ	フラッシュを焚いているカメラ 📸
くえすちょんまーく	くえすちょんまーく ❓️ ❔️
でんぱ	でんぱ 📡 📶 🛜
天狗	天狗 👺
じんばぶえ	じんばぶえ 🇿🇼
だいく	だいく 🪚
れいはい	れいはい 🛐
ソファとランプ	ソファとランプ 🛋️
うさみみ	うさみみ 👯 👯‍♀️ 👯‍♂️
ひんどぅーきょう	ひんどぅーきょう 🕉️ 🪷
べりーず	べりーず 🇧🇿
ノット	ノット 🪢
どみにかきょうわこく	どみにかきょうわこく 🇩🇴
こおり	こおり 🍧 🧊
だいす	だいす 🎲
だいず	だいず 🫛
たきしーど	たきしーど 🤵 🤵‍♀️ 🤵‍♂️
キック	キック 🦵 🦶
はーどとう・まくどなるどしょとう	はーどとう・まくどなるどしょとう 🇭🇲
はんがりー	はんがりー 🇭🇺
exclamation&question	exclamation&question ⁉️
だいや	だいや ♦️ 💍 💎 💠 🔶 🔷 🔸 🔹
ぴっくあっぷとらっく	ぴっくあっぷとらっく 🛻
てがみあり	てがみあり 📫️ 📬️
ピノキオの顔	ピノキオの顔 🤥
手を上げる	手を上げる 🙌
いえ	いえ 🏘️ 🏚️ 🏠️ 🏡 🛖
キッズ	キッズ 🧒
くせ毛	くせ毛 🦱
てをたたく	てをたたく 👏
いか	いか 🦑
顔１	顔１ 👦
ゆーろさつ	ゆーろさつ 💶
大丸１	大丸１ 🔴
めきしこ	めきしこ 🇲🇽 🪅
米	米 🌾 🍙 🍚
大丸２	大丸２ 🔵
いぎ	いぎ 🪧
話す	話す 🗣️
うお座	うお座 ♓️ 🐟️
寒暖計	寒暖計 🌡️
はちゅうるい	はちゅうるい 🐊 🐍 🐢 🦎
ぬいぐるみ	ぬいぐるみ 🧸 🧸
神話	神話 🐦‍🔥 🧚 🧝 🧞 🪽
てんたい	てんたい 🪐
さっかーぼーる	さっかーぼーる ⚽️
飛行	飛行 🪽
矢印左右	矢印左右 ↔️
いし	いし 👨‍⚕️ 👩‍⚕️ 😷 🧑‍⚕️ 🪨
キューピッド	キューピッド 💘 🪉
いす	いす 💺 💺 🦼 🦽 🪑
正月	正月 🎍
しょーつ	しょーつ 🩳
ヒーロー	ヒーロー 🦸 🦸‍♀️ 🦸‍♂️
カクテルグラス	カクテルグラス 🍸️
粥	粥 🥣
いた	いた 🎿
おとこのえるふ	おとこのえるふ 🧝‍♂️
さむい	さむい 😰 🧣 🧥
いも	いも 🍠 🥔
びでおかめら	びでおかめら 📹️
サソリ	サソリ 🦂
おんなのぼうし	おんなのぼうし 👒
いと	いと 🧵 🪡
みりあむ	みりあむ 🪬
プラカード	プラカード 🪧
山登り	山登り 🧗 🧗‍♀️ 🧗‍♂️
いぬ	いぬ 🐕️ 🐕‍🦺 🐩 🐶 🐶 🐾 🦮 🦴
cl	cl 🆑
いね	いね 🌾
フォーク	フォーク 🍴 🍽️
さむけ	さむけ 😓 😓
いわ	いわ 🪨
さむさ	さむさ 🥶
右上	右上 ↗️
右下	右下 ↘️
元素	元素 ⚛️
ＦＡＸ	ＦＡＸ 📠 📠
円札	円札 💴
進化	進化 🧬
きゃびねっと	きゃびねっと 🗄️
ぺぱろに	ぺぱろに 🍕
きいろ	きいろ 💛 🟡 🟨
バブルティー	バブルティー 🧋
とんぼかえり	とんぼかえり 🤸 🤸‍♀️ 🤸‍♂️
手荷物預かり	手荷物預かり 🛅
女の妖精	女の妖精 🧚‍♀️
ぴんくいろ	ぴんくいろ 🦩
えくあどる	えくあどる 🇪🇨
鳥の卵と巣	鳥の卵と巣 🪺
いびき	いびき 💤 💤
うける	うける 🫴
社外秘	社外秘 ㊙️
にゅうぎゅう	にゅうぎゅう 🐄
じょせいのきょうし	じょせいのきょうし 👩‍🏫
担任	担任 🧑‍🏫
うえやじるし	うえやじるし ⤴️ ⬆️
卒業	卒業 🎓️ 👨‍🎓 👩‍🎓 🧑‍🎓
紅葉	紅葉 🍁
f1	f1 🏎️
硬貨	硬貨 🪙
糸	糸 🧵 🪡
ちょうせい	ちょうせい 🎛️
りはつてん	りはつてん 💈
紙	紙 📜
鼻息	鼻息 😤
みみのふじゆうなひと	みみのふじゆうなひと 🧏
吹き出し左	吹き出し左 🗨️
だんしがくせい	だんしがくせい 👨‍🎓
車（ＲＶ）	車（ＲＶ） 🚙
みくろんとう	みくろんとう 🇵🇲
サングラスで笑顔	サングラスで笑顔 😎
めろめろ	めろめろ 🥰
がっしゅうこくりょうゆうしょうりとう	がっしゅうこくりょうゆうしょうりとう 🇺🇲
紫	紫 💜 🟣 🟪
くろわくしかく	くろわくしかく 🔲
パチパチ	パチパチ 👏
どらむすてぃっく	どらむすてぃっく 🥁
英領ヴァージン諸島	英領ヴァージン諸島 🇻🇬
くろまる	くろまる ⚫️
Eメール	Eメール ✉️ 📤️ 📥️ 📧 📨 📩
あたり	あたり 🎯
ジュエリー	ジュエリー 💍 💎
eu	eu 🇪🇺
さそりざ	さそりざ ♏️ 🦂
いー	いー 😬 😬
さんかくじょうぎ	さんかくじょうぎ 📐
甘い	甘い 🍯 😛
ほし	ほし ☪️ ✡️ ✨️ ✳️ ✴️ ⭐️ 🌃 🌟 🌠 💫 🔯 🤩 🪐
送信	送信 📤️ 📩
おーらんどしょとう	おーらんどしょとう 🇦🇽
薬	薬 🏥 💉 💊 🩹
たいまー	たいまー ⌛️ ⏲️ ⏳️
くすり	くすり 🏥 💉 💊 💊 🩹
はんとけいまわり	はんとけいまわり 🔄
女のゾンビ	女のゾンビ 🧟‍♀️
しんごうき	しんごうき 🚥 🚦
鍵（解除）	鍵（解除） 🔓️
あたま	あたま 🧠
キンポウゲ	キンポウゲ 🌼
和食	和食 🍙
忍術	忍術 🥷
絵	絵 🎨 🖼️
ほっ	ほっ ☺️ ☺️ 😌 😌
調整	調整 🎛️
きゅうめいふかん	きゅうめいふかん 🛟
かーぼべるで	かーぼべるで 🇨🇻
ジュース	ジュース 🥤 🧃
いいきぶん	いいきぶん ♨️
ザンビア	ザンビア 🇿🇲
乳製品	乳製品 🧈
ほる	ほる 🤾 🤾‍♀️ 🪏
みどりのはーと	みどりのはーと 💚
コンゴ共和国(ブラザビル)	コンゴ共和国(ブラザビル) 🇨🇬
ほね	ほね ☠️ 🍖 🍗 🦴 🩻
こうよう	こうよう 🍁
おれんじのしかく	おれんじのしかく 🟧
ほん	ほん 📔 📕 📖 📗 📘 📙 📚️
トランスジェンダー	トランスジェンダー 🌈 🏳️‍⚧️ 🏳️‍🌈
魚座	魚座 ♓️
いっこだて	いっこだて 🏠️ 🏡
ちらっ	ちらっ 🫣 🫣
三角	三角 🔺 🔻
パイン	パイン 🍍
緑	緑 🍋‍🟩 💚 🟢 🟩 🪴
電動車椅子の男性	電動車椅子の男性 👨‍🦼 👨‍🦼‍➡️
綱	綱 🪢
散髪される人	散髪される人 💇
ぶらいとねす	ぶらいとねす 🔅 🔆
建物	建物 ⛩️ ⛪️ 🏚️ 🏠️ 🏡 🏢 🏣 🏤 🏥 🏦 🏨 🏩 🏪 🏫 🏬 🏭️ 🏯 🏰 💒 🕋 🕌 🕍 🛕
天気	天気 ☀️ ☁️ ☂️ ☔️ ⛅️ ⛈️ ❄️ 🌀 🌂 🌈 🌊 🌡️ 🌤️ 🌥️ 🌦️ 🌧️ 🌨️ 🌩️ 🌪️ 🌫️
雫（涙・汗）	雫（涙・汗） 💧
ばぶる	ばぶる 🫧
かくてる	かくてる 🍸️ 🍹
キャリーケース	キャリーケース 🧳
ぴかぴか	ぴかぴか ✨️ ✨️
ふきだしひだり	ふきだしひだり 🗨️
しょくぶつ	しょくぶつ ☘️ 🌵 🌷 🌸 🌹 🌺 🌼 🍀 🏵️ 💐 🪴 🪻
とるくめにすたん	とるくめにすたん 🇹🇲
イヤホン	イヤホン 🎧️
抗議	抗議 🪧
チェリー	チェリー 🍒
水晶	水晶 🔮
指紋	指紋 🫆
虎	虎 🐅 🐯
着陸	着陸 🛬
むごん	むごん 😶
ばーすでー	ばーすでー 🎂
ようもう	ようもう 🐑 🦙
男性のマーク	男性のマーク ♂️
はくい	はくい 🥼
芸術家	芸術家 👨‍🎨 👩‍🎨 🧑‍🎨
ごしゅうぎ	ごしゅうぎ 🧧
メダル	メダル 🎖️ 🏅 🥇 🥈 🥉
縞	縞 🦓
サービス	サービス 🐕‍🦺
しんこう	しんこう 🪯
はんどぼーるをするひと	はんどぼーるをするひと 🤾
じゃぐりんぐをするおとこ	じゃぐりんぐをするおとこ 🤹‍♂️
蚊	蚊 🦟
きんぱつ	きんぱつ 👩 👩‍🦰 👩‍🦱 👩‍🦲 👩‍🦳 👱 👱‍♀️ 👱‍♂️ 👵
ぽりばけつ	ぽりばけつ 🪣
雪の結晶	雪の結晶 ❄️
虫	虫 🐌 🐛 🐜 🐝 🐞 🕷️ 🦂 🦋 🦗 🦟 🪰 🪱 🪲 🪳
id	id 🆔 🪪
王冠	王冠 👑
エクササイズ	エクササイズ 🙆
ボウリング	ボウリング 🎳
とけいまわり	とけいまわり 🔁 🔂 🔃
建設作業員	建設作業員 👷
黄色	黄色 💛 🟡 🟨
ふぁっくす	ふぁっくす 📠
疑い	疑い 🤨
バスケットボールをする男	バスケットボールをする男 ⛹️‍♂️
ばいそく	ばいそく ⏩️ ⏪️
十字架	十字架 ☦️ ⛪️ ✝️
虹	虹 🌈
CLマーク	CLマーク 🆑
すーぱー	すーぱー 🛒
ぼーと	ぼーと ⛵️ 🚣 🚣‍♀️ 🚤 🛥️ 🛶
徳利	徳利 🍶
ぼーど	ぼーど 🛹
ぼーる	ぼーる ⚽️ ⚾️ 🎱 🎳 🎾 🏀 🏈 🏉 🏏 🏐 🏑 🏓 🤾 🤾‍♀️ 🥍 🥎
じぇすちゃー	じぇすちゃー 💁 💁‍♀️ 💁‍♂️ 🙅 🙅‍♀️ 🙅‍♂️ 🙆 🙆‍♀️ 🙆‍♂️ 🙇 🙋 🙌 🙏 🤌 🤦 🤦‍♀️ 🤦‍♂️ 🤷 🤷‍♀️ 🤷‍♂️
ぺとりさら	ぺとりさら 🧫
せいようのゆうびんきょく	せいようのゆうびんきょく 🏤
てんとう虫	てんとう虫 🐞
戻る	戻る ⏪️ ◀️ 🔙
しょうか	しょうか 🧯
しょうが	しょうが 🫚
挙げたこぶし	挙げたこぶし ✊️
ばーがー	ばーがー 🍔
ごはん	ごはん 🍚 🍚
soon	soon 🔜 🔜
シマウマ	シマウマ 🦓
ほうせき	ほうせき 💎
しょうご	しょうご 🕛️
目がハート（ネコ）	目がハート（ネコ） 😻
はきそう	はきそう 🤢
ばいそん	ばいそん 🦬
つるぎ	つるぎ ⚔️ ⚔️
つなぐ	つなぐ 🧑‍🤝‍🧑 🧑‍🤝‍🧑
蜂	蜂 🐝
むっとしているひと	むっとしているひと 🙍
小丸2	小丸2 ⚫️
しかめつら	しかめつら ☹️ 😕 😦 😬 🙁
とりゅふ	とりゅふ 🍄‍🟫
しょうり	しょうり 🏁
れそと	れそと 🇱🇸
ゆうびんきょく	ゆうびんきょく 🏣
いっかくじゅう	いっかくじゅう 🦄
紳士靴	紳士靴 👞
じゃぐらー	じゃぐらー 🤹 🤹‍♀️ 🤹‍♂️
女性のマーク	女性のマーク ♀️
めいしほるだー	めいしほるだー 📇
きゃっしゅかーど	きゃっしゅかーど 💳️
じょせいけいさつかん	じょせいけいさつかん 👮‍♀️
はてなマーク（アニメ）	はてなマーク（アニメ） ❔️
「！！」	「！！」 ‼️
どーん	どーん 🎆 🎆
ろーらーすけーと	ろーらーすけーと 🛼
星座（双子座）	星座（双子座） ♊️
くろあちあ	くろあちあ 🇭🇷
羽が生えたお金	羽が生えたお金 💸
とうもろこし	とうもろこし 🌽 🌽
クリスマスイブ	クリスマスイブ 🎄
あるくおとこ	あるくおとこ 🚶‍♂️ 🚶‍♂️‍➡️
かんがっき	かんがっき 🪈
雨粒	雨粒 ☔️
ゔぁーさす	ゔぁーさす 🆚
飛び立つ	飛び立つ 🪽
ないふとふぉーく	ないふとふぉーく 🍴
じゃぐりんぐをするひと	じゃぐりんぐをするひと 🤹
得意気	得意気 😤
馬の顔	馬の顔 🐴
無言	無言 😶
有（有料）	有（有料） 🈶
はてなまーく	はてなまーく ⁉️ ❓️ ❔️
ぷれぜんと	ぷれぜんと 🎁
中華人民共和国香港特別行政区	中華人民共和国香港特別行政区 🇭🇰
すい星	すい星 ☄️
紙パック飲料	紙パック飲料 🧃
モヤイ	モヤイ 🗿
止まれの標識	止まれの標識 🛑
あぜるばいじゃん	あぜるばいじゃん 🇦🇿
矢印（右斜め下）	矢印（右斜め下） ↘️
すいえい	すいえい 🏊️ 🏊‍♀️ 🏊‍♂️ 🤽 🤽‍♀️ 🤽‍♂️ 🥽
えむおー	えむおー 💽
ほえー（ネコ）	ほえー（ネコ） 🙀
すうぇーでん	すうぇーでん 🇸🇪
まいたい	まいたい 🍹
だんせいのこっく	だんせいのこっく 👨‍🍳
わのあるわくせい	わのあるわくせい 🪐
ウォリス・フツナ	ウォリス・フツナ 🇼🇫
顔のある風	顔のある風 🌬️
ちゅにじあ	ちゅにじあ 🇹🇳
すけぼー	すけぼー 🛹
ちょうじん	ちょうじん 🦸 🦸‍♀️ 🦸‍♂️ 🦹‍♀️ 🦹‍♂️
ばすけっとぼーる	ばすけっとぼーる ⛹️ ⛹️‍♀️ ⛹️‍♂️ 🏀
蝶	蝶 🦋
缶	缶 🥫
再利用	再利用 ♻️
ブロードバンド	ブロードバンド 🛜
丸い新幹線	丸い新幹線 🚅
ちぇっくぼっくす	ちぇっくぼっくす ☑️
タバコ	タバコ 🚬 🚭️
補聴器を付けた耳	補聴器を付けた耳 🦻
パンプス	パンプス 👠
ねんど	ねんど 🧱
いきぎれ	いきぎれ 😮‍💨
じょせいのさんた	じょせいのさんた 🤶
へり	へり 🚁
あめふと	あめふと 🏈
羊	羊 🐏 🐑
ひな祭り	ひな祭り 🎎
こうつう	こうつう 🚥 🚦
ng	ng 🆖 👎️ 🙅 🙅‍♀️ 🙅‍♂️
オレンジの丸	オレンジの丸 🟠
ていし	ていし ⏹️
へび	へび 🐍 🐍
ピアノ	ピアノ 🎹
砂糖	砂糖 🧁
コック	コック 👨‍🍳 👩‍🍳 🧑‍🍳
だんせいぱいろっと	だんせいぱいろっと 👨‍✈️
おれせんぐらふ	おれせんぐらふ 📈 📉
コップ	コップ 🥛 🥤
みかん	みかん 🍊 🍊
あんぎら	あんぎら 🇦🇮
ちょこれーと	ちょこれーと 🍫
男性の探偵	男性の探偵 🕵️‍♂️
でんわのあいず	でんわのあいず 🤙
海賊旗	海賊旗 🏴‍☠️
電子メール	電子メール ✉️ 📤️ 📥️ 📧 📨 📩
雷雨	雷雨 ⛈️
ふぁいあー	ふぁいあー 🔥
らてんじゅうじ	らてんじゅうじ ✝️
さんばるてるみー	さんばるてるみー 🇧🇱
さらりーまん	さらりーまん 👨‍💼 👩‍💼 🧑‍💼
コアラ	コアラ 🐨
雷雲	雷雲 ⛈️ 🌩️
ok	ok 🆗 👌 👍️ 🙆 🙆‍♀️ 🙆‍♂️
てんぽうりん	てんぽうりん ☸️
ゴルフ	ゴルフ ⛳️ 🏌️ 🏌️‍♀️ 🏌️‍♂️ 🚩
on	on 🔛 🔛
せいじん	せいじん 🧑 🧑‍🦰 🧑‍🦱 🧑‍🦲 🧑‍🦳
うえにむけたて	うえにむけたて 🫴
ベトナム	ベトナム 🇻🇳
羽	羽 🪶 🪽
血	血 🧛
手（オッケー）	手（オッケー） 👌
ハイタッチ	ハイタッチ 🙏 🫷 🫸
イベント	イベント 🎪
あかちゃ	あかちゃ 🦰
ねっちゅうしょう	ねっちゅうしょう 🥵
自転車禁止	自転車禁止 🚳
顔４（つかれたカオ）	顔４（つかれたカオ） 😫
指（指定）	指（指定） 🈯️
pc	pc ⌨️ 💻️ 🖥️ 🖱️ 🖲️
厳禁	厳禁 🈲
シンガポール	シンガポール 🇸🇬
にっこりきす	にっこりきす 😙
ぺたんこくつ	ぺたんこくつ 🥿
ハート（緑）	ハート（緑） 💚
こいぬ	こいぬ 🐶
街	街 🏘️
著作権マーク	著作権マーク ©️
ちょさくけん	ちょさくけん ©️
へー	へー 😮 😮
天使の輪	天使の輪 😇
こいん	こいん 🪙
翼	翼 🪽
パニック	パニック 🫨
魔法の杖	魔法の杖 🪄
ぼうぐ	ぼうぐ 🛡️
泣いている猫	泣いている猫 😿
Roldex	Roldex 📇
映画（かちんこ）	映画（かちんこ） 🎬️
チャンピオン	チャンピオン 🏆️
女性と女性でキス	女性と女性でキス 👩‍❤️‍💋‍👩
環のある惑星	環のある惑星 🪐
役者	役者 🎭️
ぼうし	ぼうし ⛑️ 🎓️ 🎩 👒 👳 🤠 🥳 🧑‍🎄 🧢
なみだをこらえたかお	なみだをこらえたかお 🥹
散髪される女	散髪される女 💇‍♀️
ぼうず	ぼうず 🦲
ろーるぷれい	ろーるぷれい 🧙
けいまんしょとう	けいまんしょとう 🇰🇾
許可	許可 🉑
腹ぺこ	腹ぺこ 😋 😩
セントクリストファー・ネーヴィス	セントクリストファー・ネーヴィス 🇰🇳
うまのかお	うまのかお 🐴
ぐろーぶ	ぐろーぶ 🥊
マンガ	マンガ 💡 💢 💤 💥 💨 💬 💭
こーとじぼわーる	こーとじぼわーる 🇨🇮
すかる	すかる ☠️ 💀
たつひと	たつひと 🧍
あかみにく	あかみにく 🥩
アフロコーム	アフロコーム 🪮
すいみん	すいみん 🛏️
レベル	レベル 🎚️
虹色の旗	虹色の旗 🏳️‍🌈
軌道	軌道 🛤️
ふきげんなおとこ	ふきげんなおとこ 🙎‍♂️
とれーどまーく	とれーどまーく ™️
とらいあすろん	とらいあすろん 🏊️
刺す	刺す 🦟 🪼
せきめん	せきめん 😳
じんじゃ	じんじゃ ⛩️
ひめくりかれんだー	ひめくりかれんだー 📆
無人島	無人島 🏝️
等号	等号 🟰
ト音記号	ト音記号 🎼
車いす	車いす 👨‍🦼 👨‍🦼‍➡️ 👨‍🦽 👨‍🦽‍➡️ 👩‍🦼 👩‍🦼‍➡️ 👩‍🦽 👩‍🦽‍➡️ 🧑‍🦼 🧑‍🦼‍➡️ 🧑‍🦽 🧑‍🦽‍➡️
ダメのポーズをする人	ダメのポーズをする人 🙅
いて座	いて座 ♐️
どうが	どうが 🎦 📹️ 📼
どうき	どうき 💓
くらくら	くらくら 💫 💫 😵‍💫 😵‍💫
どうぎ	どうぎ 🥋
自転車	自転車 🚲️ 🚳 🚴 🚴‍♀️ 🚵 🚵‍♀️ 🚵‍♂️
さーかす	さーかす 🎪
あっぷる	あっぷる 🍎 🍏
気持ち	気持ち 🩷
アシカ	アシカ 🦭
あちゃー	あちゃー 🤦 🤦 🤦‍♀️ 🤦‍♀️ 🤦‍♂️ 🤦‍♂️
ちーずふぉんでゅ	ちーずふぉんでゅ 🫕
しゅどうしきくるまいす	しゅどうしきくるまいす 🦽
旅行	旅行 ✈️ 🧳
直定規	直定規 📏
バケツ	バケツ 🪣
ドルフィン	ドルフィン 🐬
rv	rv 🚙
すごいね	すごいね 😯 😯
お寿司	お寿司 🍣
不吉	不吉 🐈‍⬛
ねくたい	ねくたい 👔
えびふらい	えびふらい 🍤
かいそくてい	かいそくてい 🚤
しねま	しねま 🎞️ 🎥
てれてれ	てれてれ 😌
ぼぶすれー	ぼぶすれー 🛷
どうろ	どうろ ⛔️ 🚫 🚳 🚷 🛣️
スロバキア	スロバキア 🇸🇰
でぃすく	でぃすく 💾 💿️ 📀
どうわ	どうわ 🧚
青いハート	青いハート 💙
でぃすこ	でぃすこ 🪩
じょうざん	じょうざん ✖️ ❌️ ❎️
酒	酒 🍶
靴下	靴下 🧦
sl	sl 🚂
ハンガリー	ハンガリー 🇭🇺
小型飛行機	小型飛行機 🛩️
城（ヨーロッパ）	城（ヨーロッパ） 🏰
ぱっけーじ	ぱっけーじ 📦️
金時豆	金時豆 🫘
女の吸血鬼	女の吸血鬼 🧛‍♀️
遊具	遊具 🛝
えいびーしー	えいびーしー 🔤
3時半	3時半 🕞️
さいくりんぐ	さいくりんぐ 🚲️ 🚴 🚴‍♀️ 🚴‍♂️ 🚵 🚵‍♀️ 🚵‍♂️
ひろいん	ひろいん 🦸 🦸‍♀️
美術館	美術館 🎨 🖼️
たっきゅうびん	たっきゅうびん 📦️
パキスタン	パキスタン 🇵🇰
ページャー	ページャー 📟️
おめでとう	おめでとう ㊗️ ㊗️ 👏 👏 🥳 🥳
ふえ	ふえ 🥳 🪈
しょうとつ	しょうとつ 💥
ふか	ふか 🐣
南京錠	南京錠 🔏 🔐 🔒️ 🔓️
サックス	サックス 🎷
潮吹き	潮吹き 🐳
はくじょう	はくじょう 🦯
ふく	ふく 👔 👕 👖 👗 👘 👙 👚 👠 👡 👢 🥻 🥼 🧥
ふぐ	ふぐ 🐡 🐡
to	to 📠 📩 📲
どうしよう	どうしよう 😥 😥
しちゅー	しちゅー 🍲
ロードバイク	ロードバイク 🚴
ひだりうえやじるし	ひだりうえやじるし ↖️
巻き物	巻き物 📜
かうがーる	かうがーる 🤠
なみびあ	なみびあ 🇳🇦
上向きカーブ矢印	上向きカーブ矢印 ⤴️
ユニコーン	ユニコーン 🦄
ちぇすのこま	ちぇすのこま ♟️
うずべきすたん	うずべきすたん 🇺🇿
未成年	未成年 🔞
きんめだる	きんめだる 🏅 🥇
ちゃき	ちゃき 🫖
ふっ	ふっ 😏 😏 😼 😼
左カーブ矢印	左カーブ矢印 ↪️
ふで	ふで 🎨
金	金 🏅 🥇
ギャンブル	ギャンブル 🎰
ダビデ	ダビデ 🔯
ふる	ふる 🪇
ふぁくとりー	ふぁくとりー 🏭️
もうやだ～（悲しい顔）	もうやだ～（悲しい顔） 😖
ふろ	ふろ 🚿 🛀 🛁 🧼
ごむぞうり	ごむぞうり 🩴
ふね	ふね ⚓️ ⛴️ ⛵️ 🚢 🚣 🚣‍♀️ 🚣‍♂️ 🚤 🛥️ 🛳️ 🛶
びょうき	びょうき 💉 💊 😵 😷 🤒 🤢 🤮 🦟 🩺
up	up 🆙
せんとびんせんとおよびぐれなでぃーんしょとう	せんとびんせんとおよびぐれなでぃーんしょとう 🇻🇨
かちく	かちく 🐄 🐎 🐐 🐑 🐖
女性のスーパーヒーロー	女性のスーパーヒーロー 🦸‍♀️
ぼんやり	ぼんやり 😶‍🌫️ 😶‍🌫️
男性の芸術家	男性の芸術家 👨‍🎨
棺桶	棺桶 ⚰️
バリアフリー	バリアフリー ♿️ 🛗
針	針 💉 🪡 🪼
くまのかお	くまのかお 🐻
みーとぱい	みーとぱい 🥧
西	西 ⬅️
グラフ上向き	グラフ上向き 📈
生物学者	生物学者 🧑‍🔬 🧫 🧬
つつむて	つつむて 🤲
セウタ・メリリャ	セウタ・メリリャ 🇪🇦
ちゃど	ちゃど 🇹🇩
じゅわき	じゅわき 📞
たーばんのだんせい	たーばんのだんせい 👳‍♂️
水牛	水牛 🐃
かんせつ	かんせつ 🏔️
Cまーく	Cまーく ©️
角	角 👿 😈
こうちゃ	こうちゃ ☕️
ふくろ	ふくろ 👝
こうもり	こうもり 🦇 🦇
れゆにおん	れゆにおん 🇷🇪
9じ30ふん	9じ30ふん 🕤️
徹夜	徹夜 🫩
vs	vs 🆚
おうとするかお	おうとするかお 🤮
ミートパイ	ミートパイ 🥧
手をつなぐ	手をつなぐ 🧑‍🤝‍🧑
じてんしゃきんし	じてんしゃきんし 🚳
はくじょうをついただんせい	はくじょうをついただんせい 👨‍🦯 👨‍🦯‍➡️
プール	プール 👙
ようせい	ようせい 🧚 🧚‍♀️ 🧚‍♂️ 🧝
ろーしょんぼとる	ろーしょんぼとる 🧴
きんにく	きんにく 💪
指定席	指定席 🈯️
風船	風船 🎈
スイムウェア	スイムウェア 🩱 🩲 🩳
買い物	買い物 🛒
さむあっぷ	さむあっぷ 👍️
こーひー	こーひー ☕️
はねかえり	はねかえり 🪃
うえゆびさし	うえゆびさし ☝️
なまがき	なまがき 🦪
感嘆符疑問符	感嘆符疑問符 ⁉️
鈴	鈴 🎐 🔔 🔕
知らない	知らない 🤷 🤷‍♀️ 🤷‍♂️
カプセル	カプセル 💊
ななじ	ななじ 🕖️
雨時々晴れ	雨時々晴れ 🌦️
ビールジョッキ	ビールジョッキ 🍺
おだいり様	おだいり様 🎎
フラッシュ	フラッシュ 📸
銀	銀 🥈
はーと	はーと ♥️ ❣️ ❤️ ❤️‍🔥 ❤️‍🩹 👨‍❤️‍👨 👨‍❤️‍💋‍👨 👩‍❤️‍👨 👩‍❤️‍👩 👩‍❤️‍💋‍👨 👩‍❤️‍💋‍👩 💌 💏 💑 💓 💔 💕 💖 💗 💘 💙 💚 💛 💜 💝 💞 💟 🖤 😍 😘 😻 🤍 🤎 🥰 🧡 🩵 🩶 🩷 🫶
フォルダ１（閉）	フォルダ１（閉） 📁
銃	銃 🔫
鉤	鉤 🪝 🪝
銅	銅 🥉
鉛筆	鉛筆 ✏️ 📝
いぬのかお	いぬのかお 🐶
ようせつ	ようせつ 👨‍🏭 👩‍🏭 🥽
だんしといれ	だんしといれ 🚹️
なると	なると 🍥 🍥
はーぶ	はーぶ 🌿 🫚
はーぷ	はーぷ 🪉
よだれをたらしたかお	よだれをたらしたかお 🤤
野球場	野球場 🏟️
大人二人と子供一人の家族	大人二人と子供一人の家族 🧑‍🧑‍🧒
立っている	立っている 🧍
コントローラ	コントローラ 🎮️ 🕹️
ぺーじゃー	ぺーじゃー 📟️
コントロール	コントロール 🎛️
女性の芸術家	女性の芸術家 👩‍🎨
ケバブサンド	ケバブサンド 🥙
門松	門松 🎍
OKの手	OKの手 👌
ごりら	ごりら 🦍
たいふう	たいふう 🌀
みぎむきにおしているて	みぎむきにおしているて 🫸
DNA	DNA 🧬
教会	教会 ⛪️ 💒 🔔
みみず	みみず 🪱
じゅうりょうあげをするおんな	じゅうりょうあげをするおんな 🏋️‍♀️
てにすしゅーず	てにすしゅーず 👟
ジブチ	ジブチ 🇩🇯
スキューバ	スキューバ 🤿 🥽
そくてんするひと	そくてんするひと 🤸
荷札	荷札 🏷️
パラボラ	パラボラ 📡
とざん	とざん 🧗 🧗‍♀️ 🧗‍♂️
待った	待った 🫷 🫸
筋トレ	筋トレ 🏋️ 💪
しゅうさい	しゅうさい 🤓
ハイビスカス	ハイビスカス 🌺
イラク	イラク 🇮🇶
麦わら	麦わら 👒
竜巻	竜巻 🌪️
ＵＦＯ	ＵＦＯ 👽️
ウガンダ	ウガンダ 🇺🇬
入出国	入出国 🛂
ハートたち（複数ハート）	ハートたち（複数ハート） 💕
星座（さそり座）	星座（さそり座） ♏️
ページに付箋	ページに付箋 📑
あおいかお	あおいかお 😰 🥶
鋤	鋤 🪏
ぱとかー	ぱとかー 🚓 🚔️ 🚨
ヘアカット	ヘアカット 💇 💇‍♀️ 💇‍♂️
いるか	いるか 🐬
手（拍手）	手（拍手） 👏
たんざく	たんざく 🎋
打ちっぱなし	打ちっぱなし 🏌️
ソフトドリンク	ソフトドリンク 🥤
イラン	イラン 🇮🇷
うちゅうひこうし	うちゅうひこうし 👨‍🚀 👩‍🚀 🧑‍🚀
まーまん	まーまん 🧜‍♂️
国旗（ドイツ）	国旗（ドイツ） 🇩🇪
星座（おうし座）	星座（おうし座） ♉️
ぷっしゅぴん	ぷっしゅぴん 📌 📍
えいじのにゅうりょく	えいじのにゅうりょく 🔤
アフロ	アフロ 🦱 🪮
SOON	SOON 🔜
えっくすせん	えっくすせん 🩻
錠	錠 🔐 🔒️ 🔓️
波乗り	波乗り 🏄️ 🏄‍♀️ 🏄‍♂️
バハマ	バハマ 🇧🇸
矢印（下）	矢印（下） ⬇️
妊夫	妊夫 🫃 🫄
だんご	だんご 🍡 🍡 🎑
錨	錨 ⚓️
えいりょうゔぁーじんしょとう	えいりょうゔぁーじんしょとう 🇻🇬
だんし	だんし 🚹️
さんぴえーるしま・みくろんとう	さんぴえーるしま・みくろんとう 🇵🇲
鍋	鍋 🍲 🫕
口チャック	口チャック 🤐
だんす	だんす 💃 🕺 🦶 🩰 🪇 🪩
巻き毛	巻き毛 👨‍🦱 👩‍🦱 🦱 🧑‍🦱
きゃんせる	きゃんせる ✖️ ❌️ ❎️
チャート	チャート 💹 📈 📉 📊
suvくるま	suvくるま 🚙
ご来光	ご来光 🌄
請求書	請求書 🧾
じしん	じしん 🫨
レーザー	レーザー 🪒
いなほ	いなほ 🌾
子供	子供 👦 👧 👨‍👦 👨‍👦‍👦 👨‍👧 👨‍👧‍👦 👨‍👧‍👧 👨‍👨‍👦 👨‍👨‍👦‍👦 👨‍👨‍👧 👨‍👨‍👧‍👦 👨‍👨‍👧‍👧 👨‍👩‍👦 👨‍👩‍👦‍👦 👨‍👩‍👧 👨‍👩‍👧‍👦 👨‍👩‍👧‍👧 👩‍👦 👩‍👦‍👦 👩‍👧 👩‍👧‍👦 👩‍👧‍👧 👩‍👩‍👦 👩‍👩‍👦‍👦 👩‍👩‍👧 👩‍👩‍👧‍👦 👩‍👩‍👧‍👧 👪️ 👶 🚸 🧒
upまーく	upまーく 🆙
手動式車椅子の人	手動式車椅子の人 🧑‍🦽 🧑‍🦽‍➡️
ひたいに手をあてる人	ひたいに手をあてる人 🤦
かぎばり	かぎばり 🧶
ダメのポーズをする女	ダメのポーズをする女 🙅‍♀️
ひく	ひく ➖️
かーれーす	かーれーす 🏎️
さんぴえーるとう	さんぴえーるとう 🇵🇲
ひげ	ひげ 🥸 🥸 🧔 🧔 🧔‍♀️ 🧔‍♀️ 🧔‍♂️ 🧔‍♂️
アゼルバイジャン	アゼルバイジャン 🇦🇿
万力	万力 🗜️
ひざ	ひざ 🦵
外貨両替	外貨両替 💱
ドラムスティック	ドラムスティック 🥁
クエスチョンマーク	クエスチョンマーク ❓️ ❔️
きんか	きんか 🪙
もんしょう	もんしょう ⚜️
ヒンズー教	ヒンズー教 🕉️ 🛕
しょーとけーき	しょーとけーき 🍰
マフラー	マフラー 🧣
3じはん	3じはん 🕞️
悪い人	悪い人 🦹
ひも	ひも 🧵 🧵 🪢 🪢
水球	水球 🤽 🤽‍♀️ 🤽‍♂️
鎖	鎖 ⛓️
鍵	鍵 🔏 🔐 🔑 🔒️ 🔓️ 🗝️ 🧩
ヴァーサス	ヴァーサス 🆚
きんし	きんし ⛔️ 🈲 🔞 🙅 🙅‍♂️ 🚫 🚭️ 🚯 🚱 🚳 🚷
パトランプ	パトランプ 🚨
れずびあん	れずびあん 🌈 🏳️‍🌈
ひと	ひと 👨‍🍼 👩‍🍼 👰 👱 🙅 🙆 🙋 🚶 🚶‍➡️ 🤦 🤵 🤷 🥷 🦹 🧍 🧎 🧎‍➡️ 🧏 🧑‍🍼 🧑‍🎄 🧑‍🤝‍🧑 🧔
赤面	赤面 😳
無関心	無関心 🫤
玄関	玄関 🚪
ひな	ひな 🐣 🐣 🐤 🐤 🐥 🐥 🦢 🦢
カードフォルダー	カードフォルダー 🗂️
ざいもく	ざいもく 🪵
無限	無限 ♾️
上品	上品 🧐
ネズミの顔	ネズミの顔 🐭
かぞく	かぞく 👨‍👦 👨‍👦‍👦 👨‍👧 👨‍👧‍👦 👨‍👧‍👧 👨‍👨‍👦 👨‍👨‍👦‍👦 👨‍👨‍👧 👨‍👨‍👧‍👦 👨‍👨‍👧‍👧 👨‍👩‍👦 👨‍👩‍👦‍👦 👨‍👩‍👧 👨‍👩‍👧‍👦 👨‍👩‍👧‍👧 👩‍👦 👩‍👦‍👦 👩‍👧 👩‍👧‍👦 👩‍👧‍👧 👩‍👩‍👦 👩‍👩‍👦‍👦 👩‍👩‍👧 👩‍👩‍👧‍👦 👩‍👩‍👧‍👧 👪️ 🧑‍🧑‍🧒 🧑‍🧑‍🧒‍🧒 🧑‍🧒 🧑‍🧒‍🧒
ぱいなっぷる	ぱいなっぷる 🍍
星座（水瓶座）	星座（水瓶座） ♒️
ゔぃえす	ゔぃえす 🆚
バイオリン（クラッシック）	バイオリン（クラッシック） 🎻
よてい	よてい 📅 📆 🗓️
いでんし	いでんし 🧬
ジンバブエ	ジンバブエ 🇿🇼
じょせいのけんせつさぎょういん	じょせいのけんせつさぎょういん 👷‍♀️
ですくとっぷぱそこん	ですくとっぷぱそこん 🖥️
ほこう	ほこう 🚶 🚶‍♀️ 🚶‍♀️‍➡️ 🚶‍♂️ 🚶‍♂️‍➡️ 🚶‍➡️
くものなかのかお	くものなかのかお 😶‍🌫️
ダビデの星	ダビデの星 ✡️
トルコ	トルコ 🇹🇷
わんぴーす	わんぴーす 👗
長距離走	長距離走 🎽
せんめんじょ	せんめんじょ 🪥
むかっ	むかっ 💢 💢
しりある	しりある 🥣
天秤	天秤 ⚖️
星座（天秤座）	星座（天秤座） ♎️
おりーぶ	おりーぶ 🫒
鏡	鏡 🪞
シーク教	シーク教 🪯
パタパタ	パタパタ 🪭
すーぱーまん	すーぱーまん 🦸
羊毛	羊毛 🐑 🦙
べーこん	べーこん 🥓
ぽいすてきんし	ぽいすてきんし 🚯
キツネの顔	キツネの顔 🦊
べびーしーと	べびーしーと 🚼️
営（営業時間）	営（営業時間） 🈺
食器	食器 🍴 🍽️ 🥄
指差し（右）	指差し（右） 👉️
鐘	鐘 🔔 🔕
けんけつ	けんけつ 🩸
妊娠	妊娠 🤰 🫃 🫄
クレジットカード	クレジットカード 💳️
絆創膏	絆創膏 🩹
高層ビル	高層ビル 🏙️
眠い(睡眠)	眠い(睡眠) 💤
せーしぇる	せーしぇる 🇸🇨
プレゼント	プレゼント 🎁
パンダ	パンダ 🐼
パンチ	パンチ 👊 🤛 🤜
じゆうのめがみ	じゆうのめがみ 🗽
ニンジン	ニンジン 🥕
ばすしょうめん	ばすしょうめん 🚍️
パンツ	パンツ 👖 🩲 🩳
からかう（あっかんべえ）	からかう（あっかんべえ） 😜
会話の吹き出し	会話の吹き出し 💬
お姫さま	お姫さま 👸
まうすとらっぷ	まうすとらっぷ 🪤
多分ね	多分ね 🤷 🤷‍♀️ 🤷‍♂️
きんとれ	きんとれ 🏋️ 💪
とじたほん	とじたほん 📕
すぺーすいんべーだー	すぺーすいんべーだー 👾
やきゅうじょう	やきゅうじょう 🏟️
食事	食事 🍴
人参	人参 🥕
そくてんするおんな	そくてんするおんな 🤸‍♀️
ハートに矢	ハートに矢 💘
妊婦	妊婦 🤰 🫄
とこや	とこや 💇 💇‍♀️ 💇‍♂️ 💈
むしめがねみぎ	むしめがねみぎ 🔎
壊れたハート	壊れたハート 💔
にからぐあ	にからぐあ 🇳🇮
豆	豆 🫘 🫛
頭蓋骨	頭蓋骨 💀
スクリュードライバー	スクリュードライバー 🪛
てをあげるおとこ	てをあげるおとこ 🙋‍♂️
フォーチュンクッキー	フォーチュンクッキー 🥠
9時半	9時半 🕤️
マグカップ	マグカップ 🍺
日焼け止め	日焼け止め 🧴
豚	豚 🐖 🐷 🐽
ファイアー	ファイアー 🔥
ほこうしゃたちいりきんし	ほこうしゃたちいりきんし 🚷
NEWマーク	NEWマーク 🆕
DVD	DVD 💿️ 📀
ぷろぐらま	ぷろぐらま 👨‍💻 👩‍💻 🧑‍💻
サイクリスト	サイクリスト 🚴 🚴‍♀️ 🚵 🚵‍♀️
えすて	えすて 💆 💆‍♀️ 💆‍♂️
象	象 🐘
前の曲ボタン	前の曲ボタン ⏮️
れいんぼーふらっぐ	れいんぼーふらっぐ 🏳️‍🌈
ナイフ	ナイフ 🍴 🍽️ 🔪 🗡️
ごんどら	ごんどら 🚠 🚡
ナイス	ナイス 😀 😁
水瓶	水瓶 🏺
ぱぷあにゅーぎにあ	ぱぷあにゅーぎにあ 🇵🇬
おていれ	おていれ 🪥
落とす	落とす 🫳
きるぎす	きるぎす 🇰🇬
うっしっし（ネコ）	うっしっし（ネコ） 😸
円盤	円盤 🥏
ぎたー	ぎたー 🎸
ブロンド	ブロンド 👩 👩‍🦰 👩‍🦱 👩‍🦲 👩‍🦳 👱 👱‍♀️ 👱‍♂️ 👵
ふぃじー	ふぃじー 🇫🇯
コピーライト	コピーライト ©️
さんぱつ	さんぱつ 💇 💈
ハロウィーン	ハロウィーン 🎃 👻 🧛 🧟
たくしー	たくしー 🚕 🚖 🛺
貝	貝 🐚 🦪
でんせつ	でんせつ 🧚 🧜 🧝
ハート（ぴかぴかひかる）	ハート（ぴかぴかひかる） 💓
哺乳瓶	哺乳瓶 🍼
サキソフォン	サキソフォン 🎷
ジャグラー	ジャグラー 🤹 🤹‍♀️ 🤹‍♂️
セーシェル	セーシェル 🇸🇨
アヒル	アヒル 🪿
水泳	水泳 🏊️ 🏊‍♀️ 🏊‍♂️ 🤽 🤽‍♀️ 🤽‍♂️ 🥽
くつした	くつした 🧦
ブロンズ	ブロンズ 🥉
しろいは	しろいは 🦷
ポーチ	ポーチ 👝
ベビー	ベビー 👶 🚼️
くりかえし	くりかえし 🔁 🔂 🔃 🔄
スマートフォン禁止	スマートフォン禁止 📵
女性と女の子と男の子の家族	女性と女の子と男の子の家族 👩‍👧‍👦
しゅくじつのはた	しゅくじつのはた 🎌
みぎやじるし	みぎやじるし ➡️
ポーク	ポーク 🐖 🥩
小四角１	小四角１ ▫️
小四角２	小四角２ ▪️
薔薇	薔薇 🌹
四角数字0	四角数字0 0️⃣
不本意	不本意 😦
はい	はい 🙂‍↕️ 🙂‍↕️ 🫁
四角数字1	四角数字1 1️⃣
四角数字2	四角数字2 2️⃣
四角数字3	四角数字3 3️⃣
四角数字4	四角数字4 4️⃣
はえ	はえ 🪰
四角数字5	四角数字5 5️⃣
四角数字6	四角数字6 6️⃣
四角数字7	四角数字7 7️⃣
四角数字8	四角数字8 8️⃣
ポーズ	ポーズ ⏸️
四角数字9	四角数字9 9️⃣
うでどけい	うでどけい ⌚️
はく	はく 🤮 🧹
しゃりょうしんにゅうきんし	しゃりょうしんにゅうきんし ⛔️
ぷりんせす	ぷりんせす 👸
木工	木工 🪚
はぐ	はぐ 🤗 🫂
けがしてるかお	けがしてるかお 🤕
上下	上下 ↕️ 🪀
細菌	細菌 🦠
くろしかくだい	くろしかくだい ◼️
はこ	はこ 🎁 📤️ 📥️ 📦️ 🗃️ 🧰
えいそう	えいそう 🪹 🪺
収穫	収穫 🧺
キックスクーター	キックスクーター 🛴
おわり	おわり 🔚
はし	はし 🌉 🍜 🥡 🥢 🥢
丸めた新聞	丸めた新聞 🗞️
れすりんぐをする	れすりんぐをする 🤼‍♀️ 🤼‍♂️
ぜつぼうするねこ	ぜつぼうするねこ 🙀
不信	不信 🫤
管楽器	管楽器 🪈
はた	はた ⛳️ 🇦🇨 🇦🇩 🇦🇪 🇦🇫 🇦🇬 🇦🇮 🇦🇱 🇦🇲 🇦🇴 🇦🇶 🇦🇷 🇦🇸 🇦🇹 🇦🇺 🇦🇼 🇦🇽 🇦🇿 🇧🇦 🇧🇧 🇧🇩 🇧🇪 🇧🇫 🇧🇬 🇧🇭 🇧🇮 🇧🇯 🇧🇱 🇧🇲 🇧🇳 🇧🇴 🇧🇶 🇧🇷 🇧🇸 🇧🇹 🇧🇻 🇧🇼 🇧🇾 🇧🇿 🇨🇦 🇨🇨 🇨🇩 🇨🇫 🇨🇬 🇨🇭 🇨🇮 🇨🇰 🇨🇱 🇨🇲 🇨🇳 🇨🇴 🇨🇵 🇨🇷 🇨🇺 🇨🇻 🇨🇼 🇨🇽 🇨🇾 🇨🇿 🇩🇪 🇩🇬 🇩🇯 🇩🇰 🇩🇲 🇩🇴 🇩🇿 🇪🇦 🇪🇨 🇪🇪 🇪🇬 🇪🇭 🇪🇷 🇪🇸 🇪🇹 🇪🇺 🇫🇮 🇫🇯 🇫🇰 🇫🇲 🇫🇴 🇫🇷 🇬🇦 🇬🇧 🇬🇩 🇬🇪 🇬🇫 🇬🇬 🇬🇭 🇬🇮 🇬🇱 🇬🇲 🇬🇳 🇬🇵 🇬🇶 🇬🇷 🇬🇸 🇬🇹 🇬🇺 🇬🇼 🇬🇾 🇭🇰 🇭🇲 🇭🇳 🇭🇷 🇭🇹 🇭🇺 🇮🇨 🇮🇩 🇮🇪 🇮🇱 🇮🇲 🇮🇳 🇮🇴 🇮🇶 🇮🇷 🇮🇸 🇮🇹 🇯🇪 🇯🇲 🇯🇴 🇯🇵 🇰🇪 🇰🇬 🇰🇭 🇰🇮 🇰🇲 🇰🇳 🇰🇵 🇰🇷 🇰🇼 🇰🇾 🇰🇿 🇱🇦 🇱🇧 🇱🇨 🇱🇮 🇱🇰 🇱🇷 🇱🇸 🇱🇹 🇱🇺 🇱🇻 🇱🇾 🇲🇦 🇲🇨 🇲🇩 🇲🇪 🇲🇫 🇲🇬 🇲🇭 🇲🇰 🇲🇱 🇲🇲 🇲🇳 🇲🇴 🇲🇵 🇲🇶 🇲🇷 🇲🇸 🇲🇹 🇲🇺 🇲🇻 🇲🇼 🇲🇽 🇲🇾 🇲🇿 🇳🇦 🇳🇨 🇳🇪 🇳🇫 🇳🇬 🇳🇮 🇳🇱 🇳🇴 🇳🇵 🇳🇷 🇳🇺 🇳🇿 🇴🇲 🇵🇦 🇵🇪 🇵🇫 🇵🇬 🇵🇭 🇵🇰 🇵🇱 🇵🇲 🇵🇳 🇵🇷 🇵🇸 🇵🇹 🇵🇼 🇵🇾 🇶🇦 🇷🇪 🇷🇴 🇷🇸 🇷🇺 🇷🇼 🇸🇦 🇸🇧 🇸🇨 🇸🇩 🇸🇪 🇸🇬 🇸🇭 🇸🇮 🇸🇯 🇸🇰 🇸🇱 🇸🇲 🇸🇳 🇸🇴 🇸🇷 🇸🇸 🇸🇹 🇸🇻 🇸🇽 🇸🇾 🇸🇿 🇹🇦 🇹🇨 🇹🇩 🇹🇫 🇹🇬 🇹🇭 🇹🇯 🇹🇰 🇹🇱 🇹🇲 🇹🇳 🇹🇴 🇹🇷 🇹🇹 🇹🇻 🇹🇼 🇹🇿 🇺🇦 🇺🇬 🇺🇲 🇺🇳 🇺🇸 🇺🇾 🇺🇿 🇻🇦 🇻🇨 🇻🇪 🇻🇬 🇻🇮 🇻🇳 🇻🇺 🇼🇫 🇼🇸 🇽🇰 🇾🇪 🇾🇹 🇿🇦 🇿🇲 🇿🇼 🎌 🏁 🏳️ 🏳️‍⚧️ 🏴 🏴󠁧󠁢󠁥󠁮󠁧󠁿 🏴󠁧󠁢󠁳󠁣󠁴󠁿 🏴󠁧󠁢󠁷󠁬󠁳󠁿 🚩
ぼっくす	ぼっくす 🗃️
おびきよせる	おびきよせる 🪤
ユニコーンの顔	ユニコーンの顔 🦄
ジャグリングする人	ジャグリングする人 🤹
はち	はち 🐝
怒った	怒った 💢 😠
はつ	はつ 🔰
危険・警告	危険・警告 ⚠️
はで	はで 🦚 🦩
キャンディ（ぺろぺろ）	キャンディ（ぺろぺろ） 🍭
蓮華座のポーズ	蓮華座のポーズ 🧘
無音	無音 🔇
はと	はと 🕊️
具合の悪い顔	具合の悪い顔 🤢
はり	はり 💉 🪡 🪼
はな	はな 🌷 🌸 🌹 🌺 🌻 🌼 🏵️ 🐽 👃 💐 💮 🥀 🪷 🪻
はれ	はれ ☀️ 🌤️
はね	はね 🪶 🪽
そーせーじ	そーせーじ 🌭
調味料	調味料 🧂 🫙
安全ベスト	安全ベスト 🦺
ぶるーべりー	ぶるーべりー 🫐
チャート（棒グラフ）	チャート（棒グラフ） 📊
つえをついたじょせい	つえをついたじょせい 👩‍🦯 👩‍🦯‍➡️
Ｚｚｚ	Ｚｚｚ 💤
お年玉	お年玉 🧧
ふーん	ふーん 😑 😑 😕 😕 🫥 🫥
ばなな	ばなな 🍌
荷物	荷物 📦️
ぱーてぃー	ぱーてぃー 🎉 🎊 👯‍♀️ 👯‍♂️ 🥳 🪅 🪇 🪩
赤	赤 ❤️ 🔴 🔺 🔻 🟥
ひらいたて	ひらいたて 🖐️
薄い青のハート	薄い青のハート 🩵
闇	闇 🌑
べーぐる	べーぐる 🥯
てつどう	てつどう 🚂 🚃 🚄 🚅 🚈 🛤️
留め金	留め金 🪝
いちじていし	いちじていし ⏯️ ⏸️
口惜しさ	口惜しさ 🫦
ばってりー	ばってりー 🔋 🪫
ポケベル	ポケベル 📟️
ぷろじぇくたー	ぷろじぇくたー 📽️
ひたいに手をあてる女	ひたいに手をあてる女 🤦‍♀️
ピクルス	ピクルス 🥒
よっと	よっと ⛵️
ダガー	ダガー 🗡️
がっくり	がっくり 😞 😞
さぼてん	さぼてん 🌵 🏜️
ボート（競艇）	ボート（競艇） 🚤
べんき	べんき 🚽
どうでもいい	どうでもいい 🫥 🫥
星座（おとめ座）	星座（おとめ座） ♍️
シャツ	シャツ 👔 👕 👚
ヒジャブ	ヒジャブ 🧕
だいなまいと	だいなまいと 🧨
べんざ	べんざ 🚽
サンタさん	サンタさん 🧑‍🎄
がま口財布	がま口財布 👛
うぉっち	うぉっち ⌚️
メリーゴーランド	メリーゴーランド 🎠
足	足 👣 🦵 🦶 🦿
エヌジー	エヌジー 🆖
ろっくくらいまー	ろっくくらいまー 🧗
ふぇにっくす	ふぇにっくす 🐦‍🔥
さかなをたべる	さかなをたべる 🦦
シエラレオネ	シエラレオネ 🇸🇱
プレッツェル	プレッツェル 🥨
ひみつ	ひみつ ㊙️ 🙉 🙊 🤐
げんざん	げんざん ➖️
正座する人	正座する人 🧎 🧎‍➡️
おかねのかお	おかねのかお 🤑
てんき	てんき ☀️ ☁️ ☂️ ☔️ ⛅️ ⛈️ ❄️ 🌀 🌂 🌈 🌊 🌡️ 🌤️ 🌥️ 🌦️ 🌧️ 🌨️ 🌩️ 🌪️ 🌫️
ブラウス	ブラウス 👚
てんぐ	てんぐ 👺
木材	木材 🪵
しちめんちょう	しちめんちょう 🦃
ばすてい	ばすてい 🚏
レバノン	レバノン 🇱🇧
床屋	床屋 💇 💇‍♀️ 💇‍♂️ 💈
てんし	てんし 👼 🪽
こづつみ	こづつみ 📦️
B型	B型 🅱️
よくそう	よくそう 🛀 🛁
逆回り	逆回り 🔄
当選弓矢	当選弓矢 🎯
ラクロス	ラクロス 🥍
骨壺	骨壺 ⚱️
熱々	熱々 🍜 👨‍❤️‍👨 👩‍❤️‍👨 👩‍❤️‍👩 💑
教授	教授 👨‍🏫 👩‍🏫 🧑‍🏫
じょせいとじょせいとおんなのことおんなのこのかぞく	じょせいとじょせいとおんなのことおんなのこのかぞく 👩‍👩‍👧‍👧
きもをひやした	きもをひやした 😓
掃除	掃除 🧹 🧽
ソマリア	ソマリア 🇸🇴
いぎりす	いぎりす 🇬🇧
とるねーど	とるねーど 🌪️
てんと	てんと ⛺️ 🎪 🏕️
王妃	王妃 👸
怒りマーク	怒りマーク 💢
もーたーすぽーつ	もーたーすぽーつ 🏍️ 🏎️
列車	列車 🚂 🚃 🚆 🚉
芸術	芸術 🎨 🎭️ 🖼️
ヨガ	ヨガ 🧘 🧘‍♀️ 🧘‍♂️
くらうん	くらうん 👑
左向きに押している手	左向きに押している手 🫷
すばーるばるしょとう	すばーるばるしょとう 🇸🇯
わーい（嬉しい顔）	わーい（嬉しい顔） 😃
こんが	こんが 🪘
王女	王女 👸
ちぇっかーふらぐ	ちぇっかーふらぐ 🏁
てんぽ	てんぽ 🏬
ショット	ショット 🥃
熱い	熱い 🔥
ショック	ショック 😱 🙀 🤦 🤦‍♀️ 🤦‍♂️ 🤯 🫨
欧州連合	欧州連合 🇪🇺
2人のシルエット	2人のシルエット 👥
水着	水着 👙 🩱 🩲 🩳
英領インド洋地域	英領インド洋地域 🇮🇴
だめのぽーずをするおとこ	だめのぽーずをするおとこ 🙅‍♂️
れきしてきなたてもの	れきしてきなたてもの 🏛️
ぱらぼら	ぱらぼら 📡
くりーむちーず	くりーむちーず 🥯
むちゅう	むちゅう 😶‍🌫️ 🥰
わいしゃつ	わいしゃつ 👔
ふっかつ	ふっかつ 🐦‍🔥
てがみなし	てがみなし 📪️ 📭️
まてちゃ	まてちゃ 🧉
隠密	隠密 🥷
もも肉	もも肉 🍖 🍗
ココス(キーリング)諸島	ココス(キーリング)諸島 🇨🇨
スライダー	スライダー 🎚️
どらきゅら	どらきゅら 🧛 🧛‍♀️ 🧛‍♂️
タピオカ	タピオカ 🧋
水滴	水滴 💦 💧
雨	雨 ☂️ ☔️ ⛈️ ⛱️ 🌂 🌧️
車	車 🏎️ 🚌 🚍️ 🚐 🚑️ 🚒 🚕 🚖 🚗 🚘️ 🚙 🚚 🚛 🚜 🛞 🛻
雪	雪 ☃️ ⛄️ ❄️ 🌨️ 🎿 🏔️
ぬう	ぬう 🪡
ハート（紫）	ハート（紫） 💜
都会	都会 🌁 🌆 🏙️ 🏢
餃子	餃子 🥟
雲	雲 ☁️ ⛅️ ⛈️ 🌤️ 🌥️ 🌦️ 🌧️ 🌨️ 🌩️ 🌫️ 🌬️ 💭
あめりか	あめりか 🇺🇸 🌎️ 🗽
クッキー	クッキー 🍪
舌を出した顔	舌を出した顔 😛 🥵
ろぐ	ろぐ 🪵
ぱんけーき	ぱんけーき 🥞
雷	雷 ⚡️ ⛈️ 🌩️
リンク	リンク 🔗
ヨーヨー	ヨーヨー 🪀
めろん	めろん 🍈
リング	リング 💍 🪐
サーファー	サーファー 🏄️ 🏄‍♀️ 🏄‍♂️
リンゴ	リンゴ 🍎
車両通行止め	車両通行止め 🚫
そろばん	そろばん 🧮 🧮
リングノート	リングノート 📒
合意	合意 🤝
霧	霧 🌁 🌫️
ぷらんくとん	ぷらんくとん 🪼
もすく	もすく 🕌
台帳	台帳 📒
ペーパークリップ	ペーパークリップ 📎 🖇️
リング内	リング内 🤼 🤼‍♀️ 🤼‍♂️
男性と男性と女の子と男の子の家族	男性と男性と女の子と男の子の家族 👨‍👨‍👧‍👦
青	青 💙 🔵 🔷 🔹 🟦 🥶 🧿
会社	会社 🏢
地球	地球 🌍️ 🌎️ 🌏️ 🌐
かんげき	かんげき 🥲
口を開けた笑顔	口を開けた笑顔 😃
ろば	ろば 🫏
こうそくしたぼたん	こうそくしたぼたん ⏬️
ゆきだるまとゆき	ゆきだるまとゆき ☃️
あーてぃすと	あーてぃすと 👨‍🎤 👨‍🎨 👩‍🎤 👩‍🎨 🧑‍🎤 🧑‍🎨
さいころ	さいころ 🎲
満室・満席・満車	満室・満席・満車 🈵
えぬじーまーく	えぬじーまーく 🆖
道教	道教 ☯️
鞄	鞄 💼
ビーツ｜庭｜根｜カブ｜野菜	ビーツ｜庭｜根｜カブ｜野菜 🫜
えんぴつとめも	えんぴつとめも 📝
表情（あっかんべー）	表情（あっかんべー） 😜
古代	古代 🏛️
がいかりょうがえ	がいかりょうがえ 💱
10時半	10時半 🕥️
輪	輪 ⭕️
かじつ	かじつ 🫒
みるくてぃー	みるくてぃー 🧋
めーるじゅしん	めーるじゅしん 📩
ケイマン諸島	ケイマン諸島 🇰🇾
ばるかんじん	ばるかんじん 🖖
すまほきんし	すまほきんし 📵
ＶＳ	ＶＳ 🆚
建築	建築 🏗️ 🚩
靴	靴 👞 👟 👠 👡 👢 🥾 🩰 🩴
下向き	下向き 📉
決定	決定 🆗
まるめたしんぶん	まるめたしんぶん 🗞️
かじの	かじの 🎰
浮き輪	浮き輪 🛟
うくらいな	うくらいな 🇺🇦
飛行機着陸	飛行機着陸 🛬
しゃーぷ	しゃーぷ #️⃣
カーボベルデ	カーボベルデ 🇨🇻
ナマケモノ	ナマケモノ 🦥
手を振る	手を振る 👋
ソックス	ソックス 🧦
不可思議	不可思議 🧞
よだれ	よだれ 🤤 🤤
おだんご	おだんご 🍡 🍡
プッシュピン	プッシュピン 📍
魔法	魔法 🔮 🧙 🧚 🧝 🪄
シナゴーグ	シナゴーグ 🕍
大人一人と子供一人の家族	大人一人と子供一人の家族 🧑‍🧒
プリンス	プリンス 🤴
プリンタ	プリンタ 🖨️
ベールの女性	ベールの女性 👰‍♀️
はむすたー	はむすたー 🐹
らいおんのかお	らいおんのかお 🦁
けいれい	けいれい 🫡
トラック	トラック 🚚 🚛 🛻
げんこつ	げんこつ ✊️ ✊️ 👊 👊
どうきょう	どうきょう ☯️
ぐんようへるめっと	ぐんようへるめっと 🪖
男性と男性と女の子と女の子の家族	男性と男性と女の子と女の子の家族 👨‍👨‍👧‍👧
磁石	磁石 🧭 🧲
はなびたいかい	はなびたいかい 🎆
辰	辰 🐲
ぱたぱた	ぱたぱた 🪭
おもたい	おもたい 🪨
もくもく	もくもく 💭 💭
くちちゃっく	くちちゃっく 🤐
エレキギター	エレキギター 🎸
ごくらく	ごくらく 🪷
ばくてりあ	ばくてりあ 🦠 🧫
悪魔	悪魔 👿 😈
ツールボックス	ツールボックス 🧰
ぱとかーしょうめん	ぱとかーしょうめん 🚔️
かがくりょうほう	かがくりょうほう 🦲
あかくなる	あかくなる 😳
みずがめざ	みずがめざ ♒️
門番	門番 💂 💂‍♀️ 💂‍♂️
ちょこれーとちっぷ	ちょこれーとちっぷ 🍪
ほうがく	ほうがく 🧭
化学	化学 ⚖️ ⚗️ 🧪
しちじ	しちじ 🕖️
あごひげのひと	あごひげのひと 🧔
額	額 🖼️
目を閉じる	目を閉じる 😚
頭	頭 🧠
じょうおう	じょうおう 👸 🫅
顔	顔 ☠️ ☹️ ☺️ 🌚 🌛 🌜️ 🌝 🌞 🌬️ 🎅 🐔 🐗 🐣 🐤 🐦️ 🐧 🐨 🐭 🐮 🐯 🐰 🐱 🐲 🐴 🐵 🐶 🐷 🐸 🐹 🐺 🐻 🐼 🐽 👦 👧 👨 👨‍🦰 👨‍🦱 👨‍🦲 👨‍🦳 👩 👩‍🦰 👩‍🦱 👩‍🦲 👩‍🦳 👰 👱 👴 👵 👶 👹 👼 👽️ 👿 💀 💆‍♂️ 💩 🗣️ 🗿 😀 😁 😂 😃 😄 😅 😆 😇 😈 😉 😊 😋 😌 😍 😎 😏 😐️ 😑 😒 😓 😔 😕 😖 😗 😘 😙 😚 😛 😜 😝 😞 😟 😠 😡 😢 😣 😤 😥 😦 😧 😨 😩 😪 😫 😬 😭 😮 😮‍💨 😯 😰 😱 😲 😳 😴 😵 😶 😶‍🌫️ 😷 😸 😹 😺 😻 😼 😽 😾 😿 🙀 🙁 🙂 🙂‍↔️ 🙂‍↕️ 🙃 🙄 🤐 🤑 🤒 🤓 🤔 🤕 🤖 🤗 🤠 🤡 🤢 🤣 🤤 🤥 🤧 🤨 🤩 🤪 🤫 🤬 🤭 🤮 🤯 🥰 🥱 🥲 🥶 🥸 🥹 🥺 🦁 🦄 🦊 🦌 🦍 🦏 🧐 🧑 🧑‍🦰 🧑‍🦱 🧑‍🦲 🧑‍🦳 🧒 🧓 🧔 🧔‍♀️ 🧔‍♂️ 🫠 🫡 🫢 🫣 🫤 🫥 🫨 🫩
東京	東京 🗼
航海	航海 🧭
手（バイバイ）	手（バイバイ） 👋
見る	見る 🔎
デュエル	デュエル 🤼 🤼‍♀️ 🤼‍♂️
風邪	風邪 😷 🤒 🤧
ふらいんぐでぃすく	ふらいんぐでぃすく 🥏
王子	王子 🤴
恐怖	恐怖 😱 🧛 🧟
お月見	お月見 🎑
らいうん	らいうん ⛈️ 🌩️
逮捕する	逮捕する 👮
てんしのわがついたえがお	てんしのわがついたえがお 😇
しもん	しもん 🫆
歯科医	歯科医 😷
ざんびあ	ざんびあ 🇿🇲
営巣	営巣 🪹 🪺
オレンジの本	オレンジの本 📙
投票箱	投票箱 🗳️
洋式トイレ	洋式トイレ 🚽
白い感嘆符	白い感嘆符 ❕️
はんぎょじん	はんぎょじん 🧜
けばぶさんど	けばぶさんど 🥙
指輪	指輪 💍
グローブ	グローブ 🥊
国旗（韓国）	国旗（韓国） 🇰🇷
てをつなぐ2にん	てをつなぐ2にん 🧑‍🤝‍🧑
あごひげのだんせい	あごひげのだんせい 🧔 🧔‍♂️
いちご	いちご 🍓 🍓
血液	血液 🩸
注意マーク	注意マーク ⚠️
いちじ	いちじ 🕐️
無脊椎動物	無脊椎動物 🪼
野球帽	野球帽 🧢
4じ30ふん	4じ30ふん 🕟️
からっぽのす	からっぽのす 🪹
ハートの笑顔	ハートの笑顔 🥰
不安	不安 😨
わくせい	わくせい 🪐
ういすきー	ういすきー 🥃
ひょうてんか	ひょうてんか 🥶
足跡	足跡 🐾 👣
赤い顔	赤い顔 😡 🥵
風	風 🌬️ 🍃 🎐 🪭
おとく	おとく 🉐
こくりつこうえん	こくりつこうえん 🏞️
とっくり	とっくり 🍶
いちば	いちば 💹
いやほん	いやほん 🎧️
おとこ	おとこ ♂️ 🏄‍♂️ 🏋️‍♂️ 🏌️‍♂️ 👨 👨‍⚕️ 👨‍⚖️ 👨‍✈️ 👨‍🌾 👨‍🍳 👨‍🍼 👨‍🎓 👨‍🎤 👨‍🎨 👨‍🏫 👨‍🏭 👨‍💻 👨‍🔧 👨‍🔬 👨‍🚀 👨‍🚒 👨‍🦰 👨‍🦱 👨‍🦲 👨‍🦳 👫 👬 👯‍♂️ 👰‍♂️ 👱‍♂️ 👲 👳‍♂️ 👷‍♂️ 💁‍♂️ 💆‍♂️ 💇‍♂️ 🕴️ 🕵️ 🕵️‍♂️ 🕺 🙅‍♂️ 🙆‍♂️ 🙇‍♂️ 🙋‍♂️ 🙍‍♂️ 🙎‍♂️ 🚵‍♂️ 🤦‍♂️ 🤴 🤵‍♂️ 🤷‍♂️ 🤾‍♂️ 🧔‍♂️ 🧖‍♂️ 🧗‍♂️ 🧘‍♂️ 🧙‍♂️ 🧚‍♂️ 🧛‍♂️ 🧜‍♂️ 🧝‍♂️ 🧞‍♂️ 🧟‍♂️ 🫃
ビデオ	ビデオ 📹️ 📺️ 📼 📽️
てのひらをそろえたりょうて	てのひらをそろえたりょうて 🤲
どあ	どあ 🚪
あきや	あきや 🏚️
ハツカネズミ	ハツカネズミ 🐁
アバカス	アバカス 🧮
フランス	フランス 🇫🇷 🥐
うらない	うらない 🔮 🔯
おとす	おとす 🫳
どう	どう 🥉
ありあけづき	ありあけづき 🌘
ほねつきにく	ほねつきにく 🍖 🍗
あるばにあ	あるばにあ 🇦🇱
24時間営業	24時間営業 🏪
犬（プードル）	犬（プードル） 🐩
がぼん	がぼん 🇬🇦
どく	どく 🍄 🐍 🪼
てんびん座	てんびん座 ♎️
みりたりー	みりたりー 🪖
王家	王家 🫅
白い丸	白い丸 ⚪️
非常食	非常食 🥫
くす玉（アタリのくす玉）	くす玉（アタリのくす玉） 🎊
きどう	きどう 🛤️
うみのせいぶつ	うみのせいぶつ 🧜
おとな	おとな 👨 👨‍🦰 👨‍🦱 👨‍🦲 👨‍🦳 👩 👩‍🦰 👩‍🦱 👩‍🦲 👩‍🦳 🧑 🧑‍🦰 🧑‍🦱 🧑‍🦲 🧑‍🦳 🧓
りす	りす 🐿️ 🐿️
シュノーケリング	シュノーケリング 🤿
しゅどうしきくるまいすのだんせい	しゅどうしきくるまいすのだんせい 👨‍🦽 👨‍🦽‍➡️
ねっと	ねっと 🥅
手書き	手書き ✍️
いえめん	いえめん 🇾🇪
すぱげってぃー	すぱげってぃー 🍝
グリーンサラダ	グリーンサラダ 🥗
矢印	矢印 ↔️ ↕️ ↖️ ↗️ ↘️ ↙️ ↩️ ↪️ ⏩️ ⏪️ ⏫️ ⏬️ ⏭️ ⏮️ ⏯️ ▶️ ◀️ ➡️ ⤴️ ⤵️ ⬅️ ⬆️ ⬇️ 🔀 🔁 🔂 🔃 🔄 🔙 🔚 🔛 🔜 🔝 🔼 🔽
ブラウンマッシュルーム	ブラウンマッシュルーム 🍄‍🟫
ほっきょくぐま	ほっきょくぐま 🐻‍❄️
てんきあめ	てんきあめ 🌦️
どる	どる 💰️ 💱 💲 💵 💸
ギフト	ギフト 🎁
目隠し	目隠し 🙈
さんぐらすでえがお	さんぐらすでえがお 😎
不審	不審 🤨
いんべーだー	いんべーだー 👾
にこにこぺろり	にこにこぺろり 😋 😋
きりつ	きりつ 🧍 🧍‍♀️ 🧍‍♂️
こうさく	こうさく 👨‍🔧 👩‍🔧 🧑‍🔧
ピニャータ	ピニャータ 🪅
プログラマ	プログラマ 👨‍💻 👩‍💻 🧑‍💻
表情（チュ）	表情（チュ） 😚
きりん	きりん 🦒
表情（がーん）	表情（がーん） 😨
ニカラグア	ニカラグア 🇳🇮
えくささいず	えくささいず 🙆
社屋	社屋 🏢
すっぽん	すっぽん 🪠 🪠
トゥクトゥク	トゥクトゥク 🛺
くうぇーと	くうぇーと 🇰🇼
スバールバル諸島・ヤンマイエン島	スバールバル諸島・ヤンマイエン島 🇸🇯
きゃんでぃー	きゃんでぃー 🍬 🍭
モータースポーツ	モータースポーツ 🏁 🏍️ 🏎️
abcd	abcd 🔡 🔡
わいふぁい	わいふぁい 🛜
えきたい	えきたい 🫗 🫠
かさん	かさん ➕️
雨雲	雨雲 🌧️
圏内	圏内 📶
くりすたる	くりすたる 🔮
キャンセル	キャンセル ✖️ ❌️ ❎️
教師	教師 👨‍🏫 👩‍🏫 🧑‍🏫
はっかくあすたりすく	はっかくあすたりすく ✳️
いかりまーく	いかりまーく 💢
フクロウ	フクロウ 🦉
驚き	驚き 😦 😧 😮 😯 😱 😲 😳 🤨 🤯 🫢
じょーじあ	じょーじあ 🇬🇪
イギリス国旗	イギリス国旗 🇬🇧
燭台	燭台 🕎
唇を咬んでいる口	唇を咬んでいる口 🫦
出入国	出入国 🛂
ストック	ストック ⛷️ 🎿
手をつなぐ女性	手をつなぐ女性 👭
けんえつ	けんえつ 🤬
サンタクロース	サンタクロース 🎅 🤶 🧑‍🎄
手のひら	手のひら 👐
まかお	まかお 🇲🇴
ひだりまわりやじるし	ひだりまわりやじるし 🔄
音楽	音楽 🎙️ 🎚️ 🎛️ 🎤 🎧️ 🎵 🎶 🎷 🎸 🎹 🎺 🎻 🎼 📻️ 🥁 🪇 🪈 🪉 🪕 🪗 🪘
ストップ	ストップ ⏹️ ✋️ 🖐️ 🛑 🫷 🫸
居酒屋	居酒屋 🍺 🏮
秘密	秘密 ㊙️ 🙉 🙊 🤐
インフォメーション	インフォメーション ℹ️
駅	駅 🚉
合掌	合掌 🙏
もざんびーく	もざんびーく 🇲🇿
ゆみや	ゆみや 🏹
たんじょうび	たんじょうび 🎂 🎉 🥳 🪅
馬	馬 🎠 🏇 🐎 🐴 🫏
しし座	しし座 ♌️ 🦁
ハート３（大きい＆小さい）	ハート３（大きい＆小さい） 💕
駒	駒 ♟️
ブドウ	ブドウ 🍇
あんてぃぐあばーぶーだ	あんてぃぐあばーぶーだ 🇦🇬
義手	義手 🦾
預け入れ荷物	預け入れ荷物 🛄
きらきら星	きらきら星 🌟
らおす	らおす 🇱🇦
カタツムリ	カタツムリ 🐌
めにくまがあるかお	めにくまがあるかお 🫩
鍵盤	鍵盤 🎹
ライオン	ライオン 🦁
放射性	放射性 ☢️
ずがいこつ	ずがいこつ 💀
すいきゅう	すいきゅう 🤽 🤽‍♀️ 🤽‍♂️
FREEマーク	FREEマーク 🆓
風鈴	風鈴 🎐
水色	水色 🩵
プードル	プードル 🐩
むぎわら帽子	むぎわら帽子 👒
でんまーく	でんまーく 🇩🇰
苦悩	苦悩 😧
ぐれい	ぐれい 👽️
かふんしょう	かふんしょう 😷 🤧
おおきいひしがた	おおきいひしがた 🔶 🔷
紫の丸	紫の丸 🟣
ハンマーとレンチ	ハンマーとレンチ 🛠️
苦悶	苦悶 😧
コルク	コルク 🍾
横を向いているひよこ	横を向いているひよこ 🐤
プリンセス	プリンセス 👸
青紫	青紫 🪻
がーんじー	がーんじー 🇬🇬
ゆうびんうけ	ゆうびんうけ 📪️ 📫️ 📬️ 📭️
18きん	18きん 🔞
郵便受け	郵便受け 📪️ 📫️ 📬️ 📭️
歩行	歩行 🚶 🚶‍♀️ 🚶‍♀️‍➡️ 🚶‍♂️ 🚶‍♂️‍➡️ 🚶‍➡️
置時計	置時計 🕰️
たぶんね	たぶんね 🤷 🤷‍♀️ 🤷‍♂️
ねつをはかる	ねつをはかる 🤒
バット	バット 🏏
おじいさん	おじいさん 👴 👴
しょうぼうし	しょうぼうし 👨‍🚒 👩‍🚒 🧑‍🚒
サン・バルテルミー	サン・バルテルミー 🇧🇱
END	END 🔚
バック	バック 🔙
バッグ	バッグ 👜 👝 🛍️
エリトリア	エリトリア 🇪🇷
壊れた	壊れた ⛓️‍💥
ベナン	ベナン 🇧🇯
こくさいれんごう	こくさいれんごう 🇺🇳
バッジ	バッジ 📛
よがのぽーずをするおとこ	よがのぽーずをするおとこ 🧘‍♂️
ガーンジー	ガーンジー 🇬🇬
あおぐ	あおぐ 🪭 🪭
スマイル	スマイル ☺️ 😀 😁 😂 😃 😄 😅 😆 😇 😈 😊 😋 😍 😎 😙 😸 😹 😺 😻 🙂 🤗 🤣 🤩 🤭
でんげん	でんげん 🔌
バッタ	バッタ 🦗
めんきょしょう	めんきょしょう 🪪
おこったあくま	おこったあくま 👿
かためがね	かためがね 🧐
ロングブーツ	ロングブーツ 👢
ポンド	ポンド 💷
モンテネグロ	モンテネグロ 🇲🇪
読書	読書 📖 📗 📘 📙 📚️
らくたん	らくたん 🫥
キュウリ	キュウリ 🥒
王族	王族 👑 🤴 🫅
さむずだうん	さむずだうん 👎️
じかん	じかん ⌚️ ⏰️ ⏳️ 🕰️
おおなき	おおなき 😭
そらとぶえんばん	そらとぶえんばん 🛸
ふみきり	ふみきり 🚉
骨	骨 ☠️ 🍖 🍗 🦴 🩻
てき	てき 🎯
OKのポーズをする人	OKのポーズをする人 🙆
市場	市場 💹
申（申込み）	申（申込み） 🈸
てにもつうけとり	てにもつうけとり 🛄
きょか	きょか 🉑
交通	交通 🚥 🚦
ヨルダン	ヨルダン 🇯🇴
北マリアナ諸島	北マリアナ諸島 🇲🇵
べんきょう	べんきょう 📚️
せいざするじょせい	せいざするじょせい 🧎‍♀️ 🧎‍♀️‍➡️
工事中	工事中 🚧
スカイダイビング	スカイダイビング 🪂
注射器（血）	注射器（血） 💉
にっこり笑う猫	にっこり笑う猫 😺
やんまいえんとう	やんまいえんとう 🇸🇯
男性科学者	男性科学者 👨‍🔬
ばにーがーる	ばにーがーる 👯‍♀️
さんかくのはた	さんかくのはた 🚩
ぐれー	ぐれー 🦳 🩶
てら	てら 🛕
かれーらいす	かれーらいす 🍛
サンマリノ	サンマリノ 🇸🇲
髪	髪 💇 🪮
さーびす	さーびす 🈂️ 🐕‍🦺
LGBT	LGBT ⚧️ ⚧️ 🌈 🌈 🏳️‍⚧️ 🏳️‍⚧️ 🏳️‍🌈 🏳️‍🌈
てんしのわ	てんしのわ 😇
おかしい	おかしい 🤪 🤪
るんるん	るんるん 🎵
蹄鉄	蹄鉄 🧲
いえろーきゃぶ	いえろーきゃぶ 🚕 🚖
シク教	シク教 🪯
えすおーえす	えすおーえす 🆘
ブルージーンズ	ブルージーンズ 👖
さいきん	さいきん 🦠
はんせん	はんせん ⛵️
空マーク	空マーク 🈳
小包	小包 📦️
ちょくしもく	ちょくしもく 🦗
郵便箱	郵便箱 📪️ 📫️ 📬️ 📭️ 📮
転生	転生 🐦‍🔥
にしさはら	にしさはら 🇪🇭
急須	急須 🫖
きんぽうげ	きんぽうげ 🌼
でんきゅう	でんきゅう 💡
ぶらし	ぶらし 🪥
へあかっと	へあかっと 💇 💇‍♀️ 💇‍♂️
だいさいがい	だいさいがい 🧟
かげん	かげん 🌗
ふりすびー	ふりすびー 🥏
てをあげる	てをあげる 🙋 🙋‍♀️ 🙋‍♂️ 🙌
テニス	テニス 🎾
女性技術者	女性技術者 👩‍💻
魚	魚 🎣 🐟️ 🐠 🐡 🦈
ジョーイ	ジョーイ 🦘
okまーく	okまーく 🆗
鬼	鬼 👹
たいへんよくできました	たいへんよくできました 💮
貝殻	貝殻 🐚
考え込む顔	考え込む顔 😔
ジョーク	ジョーク 😜 🤪
通学路	通学路 🚸
あかいまる	あかいまる ⭕️ 🔴
3時30分	3時30分 🕞️
ふたござ	ふたござ ♊️
ハートつきメール	ハートつきメール 💌
こんさい	こんさい 🫜
どうめだる	どうめだる 🥉
かめるーん	かめるーん 🇨🇲
とうごう	とうごう 🟰
ひらいた	ひらいた 📬️ 📭️
長音	長音 ➰️
タピオカドリンク	タピオカドリンク 🧋
せきゆ	せきゆ 🛢️
ソフトタコス	ソフトタコス 🌯
ピンポン	ピンポン 🏓
ほうたいをまいたかお	ほうたいをまいたかお 🤕
ポルトガル	ポルトガル 🇵🇹
オリーブ	オリーブ 🫒
明かり	明かり 💡 🔦 🕯️ 🪔
溶接	溶接 👨‍🏭 👩‍🏭 🥽
工場２	工場２ 🏭️
せきひ	せきひ 🪦
げんきん	げんきん 🈲 💰️ 💷
ようがん	ようがん 🌋
ぱーてぃーくらっかー	ぱーてぃーくらっかー 🎉
傷ついた	傷ついた ❤️‍🩹
キウイフルーツ	キウイフルーツ 🥝
しせき	しせき 🏛️
ゴキブリ	ゴキブリ 🪳
しぶき｜ぺんき｜しぶき｜とびちり｜すぷらっしゅ	しぶき｜ぺんき｜しぶき｜とびちり｜すぷらっしゅ 🫟
接続	接続 🛜
温度計	温度計 🌡️
ボブスレー	ボブスレー 🛷
ドライブ	ドライブ 🚗 🚘️
ドラキュラ	ドラキュラ 🧛 🧛‍♀️ 🧛‍♂️
フォルダー	フォルダー 📁 📂 🗂️
えいがふぃるむ	えいがふぃるむ 🎞️
ミラーボール	ミラーボール 🪩
武道	武道 🥋
手（パー）	手（パー） ✋️
手（グー）	手（グー） ✊️
つめたい	つめたい 🧊
バースデーケーキ	バースデーケーキ 🎂
ひとこぶらくだ	ひとこぶらくだ 🐪
ぐらす	ぐらす 🍷 🍸️ 🥂 🥃 🥛
指差し（上）	指差し（上） 👆️
セントヘレナ	セントヘレナ 🇸🇭
ゾウ	ゾウ 🐘
散髪される男	散髪される男 💇‍♂️
うすいあおのはーと	うすいあおのはーと 🩵
たきしーどのおんな	たきしーどのおんな 🤵‍♀️
いせい	いせい 👫
魔神	魔神 🧞‍♀️ 🧞‍♂️
こどう	こどう 💓 🫀
でんどうくるまいすのひと	でんどうくるまいすのひと 🧑‍🦼 🧑‍🦼‍➡️
足首	足首 🦶
ベル消音	ベル消音 🔕
せきどうぎにあ	せきどうぎにあ 🇬🇶
農家の女性	農家の女性 👩‍🌾
さくそふぉん	さくそふぉん 🎷
ぐらふ	ぐらふ 💹 📈 📉 📊
ゆうびん	ゆうびん ✉️ 🏣 🏤 📧 📪️ 📫️ 📮 📯
ギター（エレキ）	ギター（エレキ） 🎸
ばくはつぶつ	ばくはつぶつ 🧨
ハムスター	ハムスター 🐹
マラウイ	マラウイ 🇲🇼
ひょうしき	ひょうしき ⚠️ ⛔️ 🚫 🚳 🚷 🚸 🛑
めっか	めっか 🕋
くうちゅうふゆう	くうちゅうふゆう 🕴️
べりー	べりー 🫐
左に向けた手	左に向けた手 🫲
こども	こども 👦 👧 👨‍👦 👨‍👦‍👦 👨‍👧 👨‍👧‍👦 👨‍👧‍👧 👨‍👨‍👦 👨‍👨‍👦‍👦 👨‍👨‍👧 👨‍👨‍👧‍👦 👨‍👨‍👧‍👧 👨‍👩‍👦 👨‍👩‍👦‍👦 👨‍👩‍👧 👨‍👩‍👧‍👦 👨‍👩‍👧‍👧 👩‍👦 👩‍👦‍👦 👩‍👧 👩‍👧‍👦 👩‍👧‍👧 👩‍👩‍👦 👩‍👩‍👦‍👦 👩‍👩‍👧 👩‍👩‍👧‍👦 👩‍👩‍👧‍👧 👪️ 👶 🚸 🧒
イエローキャブ	イエローキャブ 🚕 🚖
あるぜんちん	あるぜんちん 🇦🇷
エスワティニ	エスワティニ 🇸🇿
玉突き	玉突き 🎱
歩く人	歩く人 🚶
にやっとわらうねこ	にやっとわらうねこ 😸
みらーぼーる	みらーぼーる 🪩
友達	友達 👥 👫 👬 👭 🧑‍🤝‍🧑
世界	世界 🌍️ 🌎️ 🌏️ 🗺️
岩石	岩石 🪨
柔道	柔道 🥋
ふしちょう	ふしちょう 🐦‍🔥
ざんねん	ざんねん 😞
すいぞくかん	すいぞくかん 🪼
でんしめーる	でんしめーる ✉️ 📤️ 📥️ 📧 📨 📩
カヤック	カヤック 🚣 🚣‍♀️ 🚣‍♂️ 🛶
絶滅	絶滅 🦣 🦤
じゅうにし	じゅうにし 🐭 🐮 🐯 🐰 🐲
青ざめ	青ざめ 😨 😰
表彰	表彰 🎖️ 🏅 🏆️
じゅうにじ	じゅうにじ 🕛️
ジブラルタル	ジブラルタル 🇬🇮
高速上ボタン	高速上ボタン ⏫️
やぎ	やぎ 🐐
あくしゅう	あくしゅう 🦨
本１	本１ 📗
およぐおんな	およぐおんな 🏊‍♀️
本２	本２ 📘
きんぶくろ	きんぶくろ 💰️
本３	本３ 📙
本４	本４ 📕
ひきだし	ひきだし 🗄️
やし	やし 🌴 🏝️
とまと	とまと 🍅
こんとろーるつまみ	こんとろーるつまみ 🎛️
ふるーるどりす	ふるーるどりす ⚜️
とまれ	とまれ 🛑 🫷 🫸
きゅーぴっど	きゅーぴっど 💘 🪉
離陸	離陸 🛫
きっく	きっく 🦵 🦶
警備	警備 💂 💂‍♀️ 💂‍♂️
にじゅうまる	にじゅうまる 🔘
にゅーよーく	にゅーよーく 🗽
蠍座	蠍座 ♏️
凍え	凍え 🥶
上昇	上昇 📈
四角ボタン	四角ボタン 🔲 🔳
ホットケーキ	ホットケーキ 🥞
ももにく	ももにく 🍖 🍗
じょうほう	じょうほう ℹ️
きっず	きっず 🧒
減算	減算 ➖️
こうくう	こうくう 🧭
にじいろのはた	にじいろのはた 🏳️‍🌈
じしゃく	じしゃく 🧭 🧲
録音	録音 ⏺️
シャトル	シャトル 🏸
くろわっさん	くろわっさん 🥐
取り出しボタン	取り出しボタン ⏏️
ズボン	ズボン 👖
こうそうびる	こうそうびる 🏙️
大人一人	大人一人 🧑‍🧒 🧑‍🧒‍🧒
成人	成人 🧑 🧑‍🦰 🧑‍🦱 🧑‍🦲 🧑‍🦳
かくす	かくす 🙈
ＭＤ	ＭＤ 💽
牡牛座	牡牛座 ♉️
わかった	わかった 🙋
どれす	どれす 👗 🥻
溶岩	溶岩 🌋
やま	やま ⛰️ 🌋 🏔️ 🏕️ 🗻 🚵 🧗
白旗	白旗 🏳️
鳥	鳥 🐓 🐔 🐣 🐤 🐥 🐦️ 🐦‍⬛ 🐧 🕊️ 🦃 🦅 🦆 🦉 🦚 🦜 🦢 🦤 🦩 🪶 🪽 🪿
やみ	やみ 🌑
おにぎり	おにぎり 🍙 🍙
とろける	とろける 🫠 🫠
鳩	鳩 🕊️
ハートポーズ	ハートポーズ 🫶
きっぷ	きっぷ 🎫
あまい	あまい 🍯 😛
ぱそこん	ぱそこん ⌨️ 👨‍💻 👩‍💻 💻️ 🖥️ 🖱️ 🖲️ 🧑‍💻
まんもす	まんもす 🦣
有限	有限 🈶
航空	航空 🧭
ラット	ラット 🐀
歯車	歯車 ⚙️
めざまし	めざまし ⏰️ 🕙️
発射	発射 🚀
巻きページ	巻きページ 📃
リンクシンボル	リンクシンボル 🔗
無線LAN	無線LAN 🛜
だんせいとじょせいとおんなのこのかぞく	だんせいとじょせいとおんなのこのかぞく 👨‍👩‍👧
OKのポーズをする女	OKのポーズをする女 🙆‍♀️
ラッパ	ラッパ 🎺 📯
ゆうしょう	ゆうしょう 🏅 🏆️ 🥇
神秘的	神秘的 🧝
プランクトン	プランクトン 🪼
ラッコ	ラッコ 🦦
きいろいまる	きいろいまる 🟡
レッドキドニー	レッドキドニー 🫘
さんごしょう	さんごしょう 🪸
プリン	プリン 🍮
レントゲン	レントゲン 🩻
すれーとぐれー	すれーとぐれー 🩶
うったえるようなかお	うったえるようなかお 🥺
ミリタリー	ミリタリー 🪖
どーなつ	どーなつ 🍩
らいう	らいう ⛈️
ぜいかん	ぜいかん 🛃
りょこう	りょこう ✈️ 🧳
あかいほん	あかいほん 📕
片目	片目 👁️
おれんじのはーと	おれんじのはーと 🧡
おっとせい	おっとせい 🦭
とぼがん	とぼがん 🛷
骨格	骨格 🦴 🩻
じゅしんとれい	じゅしんとれい 📥️
らいす	らいす 🍚 🍛
鶏	鶏 🐔
ABCD	ABCD 🔠 🔠
あざらし	あざらし 🦭
おーがた	おーがた 🅾️
カザフスタン	カザフスタン 🇰🇿
ウクライナ	ウクライナ 🇺🇦
らいむ	らいむ 🍋‍🟩
いのしし	いのしし 🐗 🐗
都市	都市 🌆 🏙️
右回り	右回り 🔃
しかめがお	しかめがお 😦 😬 🙍 🙍‍♀️ 🙍‍♂️
らいと	らいと 🔦
うそつきのかお	うそつきのかお 🤥
勝利	勝利 🏁
はいかんこう	はいかんこう 👨‍🔧 👩‍🔧
といれ	といれ 🚹️ 🚺️ 🚻 🚽 🚾 🪠
電球	電球 💡
ぶるがりあ	ぶるがりあ 🇧🇬
子機	子機 📞
ツリー	ツリー 🎄
ジョージア	ジョージア 🇬🇪
サムズダウン	サムズダウン 👎️
みぶんしょう	みぶんしょう 🪪
ロックスター	ロックスター 👨‍🎤 👩‍🎤
さうなにはいるおんな	さうなにはいるおんな 🧖‍♀️
子犬	子犬 🐶
まらりあ	まらりあ 🦟
案内（カスタマーサービス）	案内（カスタマーサービス） 💁
だんせいけいさつかん	だんせいけいさつかん 👮‍♂️
だいもんじ	だいもんじ 🔠
ぱわーりふてぃんぐ	ぱわーりふてぃんぐ 🏋️
ドイツ国旗	ドイツ国旗 🇩🇪
ボツ	ボツ 🆖 👎️
ひのまる	ひのまる 🇯🇵 🎌
ゆうしょうかっぷ	ゆうしょうかっぷ 🏆️
建設	建設 🏗️ 👷 👷‍♀️ 👷‍♂️
げんきんじどうあずけばらいき	げんきんじどうあずけばらいき 🏧
別れ	別れ 💔
スパイス	スパイス 🫚
がちょう	がちょう 🪿
アップ	アップ 🆙
じょせいのすーぱーひーろー	じょせいのすーぱーひーろー 🦸‍♀️
レスリング	レスリング 🤼 🤼‍♀️ 🤼‍♂️
かみをふりはらう	かみをふりはらう 💁
駅伝	駅伝 🎽
せんせい	せんせい 👨‍🏫 👩‍🏫 🧑‍🏫
プライバシー	プライバシー 🔏
電気	電気 ⚡️ 🔌
さいん	さいん 🚧
祝（お祝い）	祝（お祝い） ㊗️
ちかてつ	ちかてつ Ⓜ️ 🚇️
さいふ	さいふ 👛
モーリシャス島	モーリシャス島 🦤
ひこうきりりく	ひこうきりりく 🛫
金髪の人	金髪の人 👱
ねっくれす	ねっくれす 📿
えんどる	えんどる 💱
リコーダー	リコーダー 🪈
こがたひこうき	こがたひこうき 🛩️
遊園地	遊園地 🎠 🎡 🎢
おとしだま	おとしだま 🧧
上弦	上弦 🌓
あいす	あいす 🍦 🍧 🍨
四角数字10	四角数字10 🔟
グアナコ	グアナコ 🦙
おたく	おたく 🤓
起立	起立 🧍 🧍‍♀️ 🧍‍♂️
入場パス	入場パス 🎟️
現金	現金 💰️ 💷
子猫	子猫 🐱
いなづま	いなづま ⚡️
モントセラト	モントセラト 🇲🇸
あごひげの人	あごひげの人 🧔
イタリア料理	イタリア料理 🍝
ビジネスマン	ビジネスマン 👨‍💼 🕴️
ウイスキー	ウイスキー 🥃
ベールの男性	ベールの男性 👰‍♂️
めだる	めだる 🎖️ 🏅 🥇 🥈 🥉
電池	電池 🔋
正装	正装 🤵
うえぼたん	うえぼたん 🔼
指マーク	指マーク 🈯️
あいさつ	あいさつ 👋 👋 🫂
お風呂	お風呂 🛀
ため息	ため息 😮‍💨
しろしかくとくだい	しろしかくとくだい ⬜️
白杖	白杖 🦯
かこみすうじ	かこみすうじ #️⃣ *️⃣ 0️⃣ 1️⃣ 2️⃣ 3️⃣ 4️⃣ 5️⃣ 6️⃣ 7️⃣ 8️⃣ 9️⃣ 🔟
すろばきあ	すろばきあ 🇸🇰
おべろん	おべろん 🧚
くるくる	くるくる 🌀
血液型O型	血液型O型 🅾️
標識	標識 ⚠️ ⛔️ 🚫 🚳 🚷 🚸 🛑
ピースマーク	ピースマーク ☮️
ぼとる	ぼとる 🍾
だめ	だめ 👎️ 👎️ 🙅 🙅
めも	めも 📋️ 📝
あかちゃんてんし	あかちゃんてんし 👼
伝説	伝説 🧚 🧜 🧝
あいらぶゆー	あいらぶゆー 🤟
合格	合格 🈴
赤い下三角	赤い下三角 🔻
丸太	丸太 🪵
とほほ	とほほ 😅 😅
スパーク	スパーク ❇️
こうがい	こうがい 🏠️ 🏡
つうこうどめ	つうこうどめ 🚧 🚫
ウサギの顔	ウサギの顔 🐰
鹿	鹿 🦌 🫎
水やり	水やり 🪴
絵描き	絵描き 🧑‍🎨
かがく	かがく ⚖️ ⚗️ 📡 🔍️ 🔎 🔬 🔭 🦠 🧪
男性と男性のカップル	男性と男性のカップル 👨‍❤️‍👨
軍用ヘルメット	軍用ヘルメット 🪖
位置情報	位置情報 🚩
ちゅうかじんみんきょうわこくほんこんとくべつぎょうせいく	ちゅうかじんみんきょうわこくほんこんとくべつぎょうせいく 🇭🇰
めん	めん 🍜
王様	王様 🫅
ダメのポーズをする男	ダメのポーズをする男 🙅‍♂️
ウィンドウ	ウィンドウ 🪟
ねずみ	ねずみ 🐀 🐀 🐁 🐁 🐭 🐭 🐹
大きい青のひし形	大きい青のひし形 🔷
カリウム	カリウム 🍌
しかめつらのおとこ	しかめつらのおとこ 🙍‍♂️
フィリピン	フィリピン 🇵🇭
消火器具	消火器具 🧯
あんでっど	あんでっど 🧟
ぼーとをこぐおんな	ぼーとをこぐおんな 🚣‍♀️
赤い感嘆符	赤い感嘆符 ❗️
黒	黒 ▪️ ◼️ ◾️ ⚫️ ⬛️ 🏴 🐈‍⬛ 🐦‍⬛ 🖤
じゅんれい	じゅんれい 🕋
どらむ	どらむ 🥁 🪘
歩く女	歩く女 🚶‍♀️ 🚶‍♀️‍➡️
ひだりした	ひだりした ↙️
まんぞく	まんぞく 😆 😊
ヤシの木のある島	ヤシの木のある島 🏝️
ひとをゆびさしているて	ひとをゆびさしているて 🫵
あいすらんど	あいすらんど 🇮🇸
ちきん	ちきん 🍗
麺	麺 🍜
電波	電波 📡 📶 🛜
かーどいんでっくす	かーどいんでっくす 📇
るわんだ	るわんだ 🇷🇼
アボカド	アボカド 🥑
かいてい	かいてい 🧜
ふるえているかお	ふるえているかお 🫨
ほういじしん	ほういじしん 🧭
天ぷら	天ぷら 🍤
FAX	FAX 📠
妖精	妖精 🧚 🧚‍♀️ 🧚‍♂️ 🧝
かがみ	かがみ 🪞
バタフライ	バタフライ 🦋
しおれたはな	しおれたはな 🥀
オッケー	オッケー 🆗 👌 👍️ 🙆‍♀️ 🙆‍♂️
視覚	視覚 👨‍🦯 👨‍🦯‍➡️ 👩‍🦯 👩‍🦯‍➡️ 🦮 🦯 🧑‍🦯 🧑‍🦯‍➡️
ばげっと	ばげっと 🥖
なさけ	なさけ 🥺
じてんしゃのり	じてんしゃのり 🚴 🚴‍♀️ 🚵 🚵‍♀️
携帯	携帯 📱 📳
お化け	お化け 👻
激怒	激怒 👿 😡
みぎにむけたて	みぎにむけたて 🫱
仕事かばん	仕事かばん 💼
けいたい	けいたい 📱 📲 📳 📴 📶
おばあさん	おばあさん 👵 👵
馬（全体）	馬（全体） 🐎
じょせいのげいじゅつか	じょせいのげいじゅつか 👩‍🎨
科学者	科学者 👨‍🔬 👩‍🔬 🥼 🧑‍🔬
べっど	べっど 🛌 🛏️
かいてん	かいてん 🪀
台湾	台湾 🇹🇼
みるく	みるく 🍼 🤱 🥛
曇り一時晴れ	曇り一時晴れ 🌥️
鼻	鼻 🐽 👃
ドット付きひし形	ドット付きひし形 💠
かんようしょくぶつ	かんようしょくぶつ 🪴
タキシードの人	タキシードの人 🤵
りくしゃー	りくしゃー 🛺
とらんぺっと	とらんぺっと 🎺
いじぇくと	いじぇくと ⏏️
ひばな	ひばな 🎇 🧨
ほっきょく	ほっきょく 🐻‍❄️
水道	水道 🚰
お気に入り	お気に入り 🔖
叫び	叫び 😱
レベルスライダー	レベルスライダー 🎚️
龍	龍 🐉 🐲
蒸気	蒸気 🧖
みなと	みなと ⚓️
3位	3位 🥉
丸い押しピン	丸い押しピン 📍
かいじゅう	かいじゅう 🦭
たばこ	たばこ 🚬 🚬 🚭️
会計	会計 🧾
男性と女性と女の子と男の子の家族	男性と女性と女の子と男の子の家族 👨‍👩‍👧‍👦
うぇーるず	うぇーるず 🏴󠁧󠁢󠁷󠁬󠁳󠁿
クリスタル	クリスタル 🔮
タワー	タワー 🗼
ＶＳ（バーサス）	ＶＳ（バーサス） 🆚
オートレース	オートレース 🏍️
ぴんぽん	ぴんぽん 🏓
ぎゃくさいせい	ぎゃくさいせい ◀️
みなみ	みなみ ⬇️
ゆびをくろす	ゆびをくろす 🤞 🫰
ぶるんじ	ぶるんじ 🇧🇮
しんじられない	しんじられない 😮 🤦 🤦‍♀️ 🤦‍♂️
ふぃーるどほっけー	ふぃーるどほっけー 🏑
こっき	こっき 🇨🇳 🇩🇪 🇪🇸 🇫🇷 🇬🇧 🇮🇹 🇯🇵 🇰🇷 🇷🇺 🇺🇸 🏴
コモロ	コモロ 🇰🇲
けいたいじゅしん	けいたいじゅしん 📲
アルバニア	アルバニア 🇦🇱
ジジ	ジジ 🃏
こっく	こっく 👨‍🍳 👩‍🍳 🧑‍🍳
女性警察官	女性警察官 👮‍♀️
テープ	テープ 📼
ヘリコプター	ヘリコプター 🚁
ベル	ベル 🔔 🛎️
きぷろす	きぷろす 🇨🇾
SOS	SOS 🆘
洗面所	洗面所 🪥
兵士	兵士 🪖
すーぱーひーろー	すーぱーひーろー 🦸
ピトケアン諸島	ピトケアン諸島 🇵🇳
手をつなぐ男性	手をつなぐ男性 👬
困った顔	困った顔 ☹️ 😧
人形	人形 🎎 🪅 🪆
ねくたりん	ねくたりん 🍊
こっぷ	こっぷ 🥛 🥤
かんがえる	かんがえる 🤔 🧐
ふぉーく	ふぉーく 🍴 🍽️
がーでなー	がーでなー 🧑‍🌾
おまえだ	おまえだ 🫵 🫵
ポリス	ポリス 👮
会話	会話 💬 🗨️
幸運	幸運 🧧
掛け算	掛け算 ✖️ ❌️ ❎️
ダブルループ	ダブルループ ➿️
腕時計	腕時計 ⌚️
人影	人影 👤
おおもじ	おおもじ 🔠
ブルーボネット	ブルーボネット 🪻
警告	警告 ⚠️
すっぱい	すっぱい 🍋 🍋‍🟩
男性と女性と女の子と女の子の家族	男性と女性と女の子と女の子の家族 👨‍👩‍👧‍👧
さんぱつされるおんな	さんぱつされるおんな 💇‍♀️
ラーメン	ラーメン 🍜
いんりょうすい	いんりょうすい 🚰
あめりかたいりく	あめりかたいりく 🌎️
ろざりお	ろざりお 📿
そり	そり 🛷 🛷
はくしゅ	はくしゅ 👏
公衆トイレ	公衆トイレ 🚻
うえむきさんかく	うえむきさんかく 🔺 🔼
電源	電源 🔌
ｱﾝﾃﾅ（位置情報ﾏｰｸ）	ｱﾝﾃﾅ（位置情報ﾏｰｸ） 📡
はんげつ	はんげつ 🌓 🌗 🌛 🌜️
くもがたのふきだし	くもがたのふきだし 💭
かーと	かーと 🛒
コップから注ぐ	コップから注ぐ 🫗
かーど	かーど ♠️ ♣️ ♥️ ♦️ 🃏 🎴 💳️ 🗃️
風邪薬	風邪薬 💊
紫ハート	紫ハート 💜
かーる	かーる 📃 🦱
フルーツ	フルーツ 🍋‍🟩 🥭
れべる	れべる 🎚️
フルート	フルート 🪈
あすくれぴおすのつえ	あすくれぴおすのつえ ⚕️
ピンヒール	ピンヒール 👠
かーば	かーば 🕋
ほっとけーき	ほっとけーき 🥞
言わざる	言わざる 🙊
ホテル２	ホテル２ 🏩
まんせき	まんせき 🈵
きりかぶ	きりかぶ 🪵
チャド	チャド 🇹🇩
ういてるびじねすまん	ういてるびじねすまん 🕴️
くすだま	くすだま 🎊
かーぶ	かーぶ ↩️ ↪️ ⤴️ ⤵️
Tシャツ（ボーダー）	Tシャツ（ボーダー） 👕
ほっとすぽっと	ほっとすぽっと 🛜
五線譜	五線譜 🎼
なみせん	なみせん 〰️
どみにかこく	どみにかこく 🇩🇲
金髪の女性	金髪の女性 👱‍♀️
青い四角	青い四角 🟦
ジェットコースター	ジェットコースター 🎢
ういんく	ういんく 😉
けいれいするかお	けいれいするかお 🫡
仕掛け	仕掛け 🪤
かさとあめ	かさとあめ ☔️
わいん	わいん 🍷
おやゆびさいん	おやゆびさいん 👍️
ふらっしゅ	ふらっしゅ 📸
はにー	はにー 🍯
しゅりんぷ	しゅりんぷ 🦐
マウストラップ	マウストラップ 🪤
あめりかんふっとぼーる	あめりかんふっとぼーる 🏈
カップル	カップル 👨‍❤️‍👨 👨‍❤️‍💋‍👨 👩‍❤️‍👨 👩‍❤️‍👩 👩‍❤️‍💋‍👨 👩‍❤️‍💋‍👩 👫 👬 👭 💏 💑 🧑‍🤝‍🧑
むしめがね	むしめがね 🔍️ 🔍️ 🔎 🕵️ 🕵️‍♀️ 🕵️‍♂️
煉瓦	煉瓦 🧱
童話	童話 🧚
道着	道着 🥋
せいざ	せいざ ♈️ ♉️ ♊️ ♋️ ♌️ ♍️ ♎️ ♏️ ♐️ ♑️ ♒️ ♓️ ⚖️ ⛎️ 🏹 🏺 🐂 🐍 🐏 🐐 🐟️ 🦀 🦁 🦂
ネコの顔	ネコの顔 🐱
選挙	選挙 🗳️
みにばす	みにばす 🚐
早送りボタン	早送りボタン ⏩️
トルクメニスタン	トルクメニスタン 🇹🇲
あたまばくはつ	あたまばくはつ 🤯
液体	液体 🫗 🫠
さいほう	さいほう 🧵 🪡
せいち	せいち 🕋
誘惑	誘惑 🫦
ひやあせえがお	ひやあせえがお 😅
米領サモア	米領サモア 🇦🇸
ですくとっぷ	ですくとっぷ 🖥️
ひたいに手をあてる男	ひたいに手をあてる男 🤦‍♂️
せいり	せいり 🩸
ゆびわ	ゆびわ 💍
なげる	なげる 🤾 🤾‍♀️
アイラブユー	アイラブユー 🤟
はんどぼーる	はんどぼーる 🤾 🤾‍♀️ 🤾‍♂️
はったんじゅうじか	はったんじゅうじか ☦️
メロディ	メロディ 🎶
もくげき	もくげき 👁️‍🗨️
お墓	お墓 🪦
ガーデナー	ガーデナー 🧑‍🌾
あんない	あんない 💁 💁‍♀️ 💁‍♂️
どんっ（衝撃）	どんっ（衝撃） 💥
ぐあいのわるいかお	ぐあいのわるいかお 🤢
せいふ	せいふ 🧲
たいそう	たいそう 🤸 🤸‍♀️ 🤸‍♂️
ぱらぐらいだー	ぱらぐらいだー 🪂
宇宙旅行	宇宙旅行 🚀
大きくなるハート	大きくなるハート 💗
落ち葉	落ち葉 🍁 🍂 🍃
わしょく	わしょく 🍙
えいが	えいが 🎞️ 🎥 🎦 🎬️ 📽️
ものづくり	ものづくり 🧑‍🏭
そふとたこす	そふとたこす 🌯
えいご	えいご 🔤
えいじ	えいじ 🔠 🔡 🔤
溶けている顔	溶けている顔 🫠
上向き	上向き 📈
すくーたー	すくーたー 🛵
すいしょうきゅう	すいしょうきゅう 🔮
こんがん	こんがん 🥹 🥺
きらきらハート	きらきらハート 💖
ケニア	ケニア 🇰🇪
せいなるしんぞう	せいなるしんぞう ❤️‍🔥
しろぬきのちぇっく	しろぬきのちぇっく ✅️
路面電車正面	路面電車正面 🚊
サイ	サイ 🦏
ブイ	ブイ 🛟
歩く屍	歩く屍 🧟
三角の旗	三角の旗 🚩
こだい	こだい 🏛️
ニュージーランド	ニュージーランド 🇳🇿
べらんだ	べらんだ 🪴
100てん	100てん 💯
バースデー	バースデー 🎂
兄弟	兄弟 👬
犯罪者	犯罪者 🦹
ダム作り	ダム作り 🦫
2時30分	2時30分 🕝️
ブタ	ブタ 🐖 🐷 🐽
手をつなぐ男女	手をつなぐ男女 👫
サメ	サメ 🦈
薄い青	薄い青 🩵
手漕ぎボート	手漕ぎボート 🚣 🚣‍♀️
拡大鏡	拡大鏡 🔍️ 🔎
小さいオレンジのひし形	小さいオレンジのひし形 🔸
男子学生	男子学生 👨‍🎓
おとなふたり	おとなふたり 🧑‍🧑‍🧒 🧑‍🧑‍🧒‍🧒
きょうだい	きょうだい 👬
へるめっと	へるめっと ⛑️ 👷 👷‍♀️ 👷‍♂️ 🪖
サル	サル 🐒 🐵 🦧
せいざするひと	せいざするひと 🧎 🧎‍➡️
りようしつ	りようしつ 💇 💇‍♂️ 💈
めっせーじ	めっせーじ 💬
あしくび	あしくび 🦶
ライラック	ライラック 🪻
タキシードの女	タキシードの女 🤵‍♀️
国王	国王 🫅
クリケット	クリケット 🏏
クランプ	クランプ 🗜️
八角アスタリスク	八角アスタリスク ✳️
バランス	バランス ⚖️
ばいおりん	ばいおりん 🎻
びよういん	びよういん ✂️ 💇 💇‍♀️ 💇‍♂️ 💈
かざふすたん	かざふすたん 🇰🇿
ピックアップトラック	ピックアップトラック 🛻
ぞうき	ぞうき 🫀 🫁
りょうりにん	りょうりにん 👨‍🍳 👩‍🍳
マスク顔	マスク顔 😷
おすし	おすし 🍣
冷や汗青ざめ	冷や汗青ざめ 😰
バイオハザード	バイオハザード ☣️
つえをついただんせい	つえをついただんせい 👨‍🦯 👨‍🦯‍➡️
カイト	カイト 🪁
スプーン	スプーン 🥄
表情（おろおろ）	表情（おろおろ） 😰
かみふぶき	かみふぶき 🎊
低輝度	低輝度 🔅
ちぇあ	ちぇあ 🪑
しょうきん	しょうきん 💰️
たいおんけい	たいおんけい 🤒
やじるし	やじるし ↔️ ↕️ ↖️ ↗️ ↘️ ↙️ ↩️ ↪️ ⏩️ ⏪️ ⏫️ ⏬️ ⏭️ ⏮️ ⏯️ ▶️ ◀️ ➡️ ⤴️ ⤵️ ⬅️ ⬆️ ⬇️ 👆️ 👇️ 👈️ 👉️ 🔀 🔁 🔂 🔃 🔄 🔙 🔚 🔛 🔜 🔝 🔼 🔽
サムズアップ	サムズアップ 👍️
ターキー	ターキー 🍗 🦃
めだまやき	めだまやき 🍳
湯のみ	湯のみ 🍵
かくとうぎ	かくとうぎ 🥋
四角	四角 ⏹️ ▪️ ▫️ ◻️ ◼️ ◽️ ◾️ ⬛️ ⬜️ 🔶 🔷 🔸 🔹 🟥 🟦 🟧 🟨 🟩 🟪 🟫
ちぇこ	ちぇこ 🇨🇿
とらのかお	とらのかお 🐯
おーとれーす	おーとれーす 🏍️
あおざめ	あおざめ 😨 😰
耳の不自由な人	耳の不自由な人 🧏
ちぇす	ちぇす ♟️
9時	9時 🕘️
しくきょう	しくきょう 🪯
操縦士	操縦士 👨‍✈️ 👩‍✈️ 🧑‍✈️
正負	正負 🧲
キャッシュ	キャッシュ 💰️
輪っか	輪っか ➰️ ➿️
アクセプト	アクセプト 🉑
くうそう	くうそう 💭
予防接種	予防接種 💉
かねもち	かねもち 💰️
てぃらのさうるす	てぃらのさうるす 🦖
燃える	燃える 🔥
えいえん	えいえん ♾️
発熱	発熱 🥵
とっぷう	とっぷう 🌪️
開いた手	開いた手 🖐️
等しい	等しい 🟰
ブルガリア	ブルガリア 🇧🇬
スロット（７７７）	スロット（７７７） 🎰
アイルランド	アイルランド 🇮🇪
ほほえむ	ほほえむ 🙂
右斜め上	右斜め上 ↗️
こうれいしゃ	こうれいしゃ 👴 👵 🦳 🧓
右斜め下	右斜め下 ↘️
オーケストラ	オーケストラ 🪈 🪉
じょうひん	じょうひん 🧐
赤い四角	赤い四角 🟥
ていりゅうじょ	ていりゅうじょ 🚏
庵点	庵点 〽️
びりやーど	びりやーど 🎱
こううん	こううん 🧧
ローファー	ローファー 👞
グリーンピース	グリーンピース 🫛
農家の男性	農家の男性 👨‍🌾
表情（いー）	表情（いー） 😝
じぶち	じぶち 🇩🇯
ワタリガラス	ワタリガラス 🐦‍⬛
6じはん	6じはん 🕡️
コンパス	コンパス 🧭
めをまわしたかお	めをまわしたかお 😵‍💫
魔術	魔術 🪄
国旗（イタリア）	国旗（イタリア） 🇮🇹
洗濯	洗濯 🧺
くいーん	くいーん 👸
郵便ラッパ	郵便ラッパ 📯
ぶらきおさうるす	ぶらきおさうるす 🦕
建設中	建設中 🏗️
万物	万物 ♾️
時計（６時）	時計（６時） 🕕️
みみずく	みみずく 🦉
赤い疑問符	赤い疑問符 ❓️
主張	主張 🪧
しかめっ面	しかめっ面 😬 🙍 🙍‍♀️ 🙍‍♂️
ほほえみ	ほほえみ 😊 🙂 🙂
右向きのこぶし	右向きのこぶし 🤜
カート	カート 🛒
カード	カード ♠️ ♣️ ♥️ ♦️ 🃏 🎴 💳️ 🗃️
あふろ	あふろ 🦱 🪮
2にんできす	2にんできす 👨‍❤️‍💋‍👨 👩‍❤️‍💋‍👨 👩‍❤️‍💋‍👩 💏
高電圧	高電圧 ⚡️
祝日マーク	祝日マーク 🎌
めをあけてくちにてをあてたかお	めをあけてくちにてをあてたかお 🫢
カーバ	カーバ 🕋
もんとせらと	もんとせらと 🇲🇸
音符	音符 🎵 🎶
カーブ	カーブ ↩️ ↪️ ⤴️ ⤵️
すとらいく	すとらいく 🎳
トレードマーク（TM）	トレードマーク（TM） ™️
ぷーる	ぷーる 👙
テレビゲーム	テレビゲーム 🎮️ 🕹️
かいめん	かいめん 🧽
体温計	体温計 🤒
ソファ	ソファ 🛋️
沈黙	沈黙 😶
はーとでこ	はーとでこ 💟
あかいふうとう	あかいふうとう 🧧
おうかんをかぶったひと	おうかんをかぶったひと 🫅
得（お得）	得（お得） 🉐
おせんべい	おせんべい 🍘
かくぼう	かくぼう 🎓️ 👨‍🎓 👩‍🎓 🧑‍🎓
ソフト	ソフト 🍦
ちまき	ちまき 🫔 🫔
スピーカー	スピーカー 📢 📣 🔇 🔈️ 🔉 🔊
しゃーぷだいやる	しゃーぷだいやる #️⃣
スパーク２（キラリマーク）	スパーク２（キラリマーク） ✴️
ひしがた	ひしがた 💠 🔶 🔷 🔸 🔹
トライデント	トライデント 🔱
とりのたまごとす	とりのたまごとす 🪺
ははおや	ははおや 👩‍🍼 🧑‍🍼
おーけーのぽーずをするおとこ	おーけーのぽーずをするおとこ 🙆‍♂️
カール	カール 📃 🦱
大きいオレンジのひし形	大きいオレンジのひし形 🔶
うちゅう	うちゅう ☄️ 🌌 🌑 🌒 🌓 🌔 🌕️ 🌖 🌗 🌘 🌙 🌠 🚀 🛰️ 🛸
えれきぎたー	えれきぎたー 🎸
パズル	パズル 🧩
ぶるーれい	ぶるーれい 💿️ 📀
射手座	射手座 ♐️ 🏹
ちょっと待って	ちょっと待って 🫷 🫸
りょうがえ	りょうがえ 💱
聖なる心臓	聖なる心臓 ❤️‍🔥
ハートデコ	ハートデコ 💟
中華菓子	中華菓子 🥮
ピタパン	ピタパン 🥙 🫓
とんぐさんだる	とんぐさんだる 🩴
せかいちず	せかいちず 🗺️
とうきょう	とうきょう 🗼
高速	高速 🛣️
ゲイ	ゲイ 🌈 🏳️‍🌈
不満	不満 😒 😠 😦 🙍 🫤
ごみかご	ごみかご 🗑️ 🗑️
えんだか	えんだか 💹
オートミール	オートミール 🥣
スピーカー消音	スピーカー消音 🔇
我慢する顔	我慢する顔 😣
はつづき	はつづき 🌒
ガラス	ガラス 🫗
そくてん	そくてん 🤸 🤸‍♀️ 🤸‍♂️
たると	たると 🥧
てをつなぐふたり	てをつなぐふたり 🧑‍🤝‍🧑
観葉植物	観葉植物 🪴
顕微鏡	顕微鏡 🔬
登山靴	登山靴 🥾
けーき	けーき 🍰 🎂 🧁
日傘	日傘 ⛱️
受付嬢	受付嬢 💁
あみもの	あみもの 🧶
農場主	農場主 🧑‍🌾
巻き貝	巻き貝 🐚
あおざめたかお	あおざめたかお 😨
公園	公園 🏞️ 🛝
縫い針	縫い針 🧵 🪡
ねったいぎょ	ねったいぎょ 🐠
ろぼっと	ろぼっと 🤖
しんどう	しんどう 🫨
ビル	ビル 🌆 🌇 🏢 🏬
ケガしてる顔	ケガしてる顔 🤕
女子トイレ	女子トイレ 🚺️
zzz	zzz 💤 💤 😴 😴
シンボルが口にある顔	シンボルが口にある顔 🤬
アルティメット	アルティメット 🥏
愛してる	愛してる 🤟 🥰 🩷
とんかち	とんかち ⚒️ ⚒️ 🔨 🔨 🛠️ 🛠️
けーる	けーる 🥬
けんばん	けんばん 🎹
とんが	とんが 🇹🇴
モアイ	モアイ 🗿
ふかしぎ	ふかしぎ 🧞
ＯＫ！２	ＯＫ！２ 🙆
なんせい	なんせい ↙️
封筒と矢印	封筒と矢印 📩
天気雨	天気雨 🌦️
しお	しお 🐳 🧂
しか	しか 🦌 🫎
こそぼ	こそぼ 🇽🇰
オレンジの四角	オレンジの四角 🟧
とざんぐつ	とざんぐつ 🥾
大菱形１	大菱形１ 🔶
大菱形２	大菱形２ 🔷
かーかー	かーかー 🐦‍⬛
あるくひと	あるくひと 🚶
パレット	パレット 🎨 👩‍🎨
しし	しし 🐯
しけんかん	しけんかん 🧪
しょうおん	しょうおん 🔇 🔕
登る	登る 🧗 🪜
ふぇりー	ふぇりー ⛴️
演劇	演劇 🎩 🎭️
した	した ⏬️ ⤵️ ⬇️ 👅 👇️ 👎️ 🔻 🔽 😛 😜 😝 🤑 🫳
しゅえい	しゅえい 💂 💂‍♀️ 💂‍♂️
しっ	しっ 🤫 🤫
phone	phone 📲
サーチ（調べる）	サーチ（調べる） 🔍️
らんぷ	らんぷ 🛋️ 🪔
ぼたん	ぼたん ⏏️ ⏩️ ⏫️ ⏬️ ⏭️ ⏮️ ⏯️ ⏸️ ⏹️ ⏺️ ▶️ ◀️ 🔀 🔁 🔂 🔘 🔲 🔳 🔼 🔽
マティーニ（カクテルグラス）	マティーニ（カクテルグラス） 🍸️
ふろっぴー	ふろっぴー 💾
しろ	しろ ▫️ ◻️ ◽️ ⚪️ ⬜️ 🏯 🏰 🏳️ 🐻‍❄️ 🤍
日光	日光 ☀️ 🌅
わりびき	わりびき 🈹
しゃわー	しゃわー 🚿
ほいくしょ	ほいくしょ 📛
さんご	さんご 🪸
万歳	万歳 🙌
6時	6時 🕕️
きしゃ	きしゃ 🚂
しん	しん 🆕 🈸
きしゅ	きしゅ 🏇
さっかー	さっかー ⚽️
さんじ	さんじ 🕒️
まうんてんばいくにのるおんな	まうんてんばいくにのるおんな 🚵‍♀️
ＡＢ	ＡＢ 🆎
不潔	不潔 🪰
さんた	さんた 🎅 🧑‍🎄
ぶたのかお	ぶたのかお 🐷
しま	しま 🏝️ 🦓
へんそうしたかお	へんそうしたかお 🥸
施術	施術 💆
自由形	自由形 🏊️
燃えるハート	燃えるハート ❤️‍🔥
ごうかく	ごうかく 🈴
指紋｜鑑識｜生体認証｜セキュリティ	指紋｜鑑識｜生体認証｜セキュリティ 🫆
はろうぃん	はろうぃん 🎃
ぴーこっく	ぴーこっく 🦚
小屋	小屋 🛖
酸っぱい	酸っぱい 🍋 🍋‍🟩
西洋の城	西洋の城 🏰
としょかん	としょかん 📖 📗 📘 📙
あかいはこ	あかいはこ 🧰
あすりーと	あすりーと 🤾
さんぽ	さんぽ 🚶 🚶‍♀️ 🚶‍♀️‍➡️ 🚶‍➡️
パモーニャ	パモーニャ 🫔
アルパカ	アルパカ 🦙
悲しい	悲しい ☹️ 😔 😞 😟 😢 😭 😿
ドクロと骨	ドクロと骨 ☠️
おこった	おこった 💢 😠
目がハート	目がハート 😍
れいはいどう	れいはいどう ⛪️ 💒
ミャンマー	ミャンマー 🇲🇲
すとろべりー	すとろべりー 🍓
咲いた花	咲いた花 🌼
水球をする人	水球をする人 🤽
手（指差し）	手（指差し） ☝️
うぉーきんぐ	うぉーきんぐ 🚶 🚶‍♀️ 🚶‍♀️‍➡️ 🚶‍♂️ 🚶‍♂️‍➡️ 🚶‍➡️
カチンコ	カチンコ 🎬️
こおろぎ	こおろぎ 🦗
ともだち	ともだち 👥 👫 👬 👭 🧑‍🤝‍🧑
がまん顔	がまん顔 😣
おじいちゃん	おじいちゃん 👴 👴
あひる	あひる 🪿
りまいんだー	りまいんだー 🎗️
くろす	くろす ✝️
ポートベロー	ポートベロー 🍄‍🟫
ながめ	ながめ 🪟
ひよこ	ひよこ 🐣 🐣 🐤 🐤 🐥 🐥
しー	しー 🤫 🤫
除外	除外 🙅
手動式車椅子の女性	手動式車椅子の女性 👩‍🦽 👩‍🦽‍➡️
フランス王家	フランス王家 ⚜️
BACK矢印	BACK矢印 🔙
スポーツ	スポーツ ⚽️ ⚾️ ⛳️ ⛷️ ⛸️ ⛹️ ⛹️‍♀️ ⛹️‍♂️ 🎣 🎯 🎱 🎳 🎽 🎾 🎿 🏀 🏁 🏂️ 🏄️ 🏄‍♀️ 🏄‍♂️ 🏅 🏇 🏈 🏉 🏊️ 🏊‍♀️ 🏊‍♂️ 🏋️ 🏋️‍♀️ 🏋️‍♂️ 🏌️ 🏌️‍♀️ 🏌️‍♂️ 🏍️ 🏎️ 🏏 🏐 🏑 🏒 🏓 🏸 🚣 🚣‍♀️ 🚣‍♂️ 🚩 🚴 🚴‍♀️ 🚴‍♂️ 🚵 🚵‍♀️ 🚵‍♂️ 🛷 🛼 🤸 🤸‍♀️ 🤸‍♂️ 🤺 🤼 🤼‍♀️ 🤼‍♂️ 🤽 🤽‍♀️ 🤽‍♂️ 🤾 🤾‍♀️ 🤾‍♂️ 🤿 🥅 🥊 🥋 🥌 🥍 🥎
アクション（ピストル）	アクション（ピストル） 🔫
ふらい	ふらい 🍤
12時半	12時半 🕧️
スポーク	スポーク 🛞
案内	案内 💁 💁‍♀️ 💁‍♂️
キャンディ（つつみ）	キャンディ（つつみ） 🍬
呼吸	呼吸 🫁
悲しみ	悲しみ 🥺
ふらぐ	ふらぐ ⛳️ 🎌 🏁 🏳️ 🏳️‍⚧️ 🏳️‍🌈 🏴 🚩
だいちょう	だいちょう 📒
びゅうびゅう	びゅうびゅう 🍃
はげあたま	はげあたま 👨‍🦲 👩‍🦲 🦲 🧑‍🦲
スクーター	スクーター 🛵
タクシー正面	タクシー正面 🚖
ネクタリン	ネクタリン 🍊
したやじるし	したやじるし ⤵️ ⬇️
わふく	わふく 👘
リクシャー	リクシャー 🛺
さかさまの顔	さかさまの顔 🙃
つうか	つうか 💱 💲 💴 💵 💶 💷
うりぼう	うりぼう 🐗
ゆびのまからのぞきみるかお	ゆびのまからのぞきみるかお 🫣
８じ	８じ 🕗️
つののゆびさいん	つののゆびさいん 🤘
仏教	仏教 ☸️ 🪷
すながおちているすなどけい	すながおちているすなどけい ⏳️
おんなのようせい	おんなのようせい 🧚‍♀️
バツ	バツ ✖️ ❌️ ❎️ 🙅 🙅‍♀️ 🙅‍♂️
だんせいのすーぱーひーろー	だんせいのすーぱーひーろー 🦸‍♂️
加算	加算 ➕️
よるだん	よるだん 🇯🇴
楽器	楽器 🎷 🎸 🎹 🎺 🎻 🥁 🪇 🪈 🪉 🪕 🪗 🪘
ぴーまん	ぴーまん 🫑
すみれしょく	すみれしょく 🪻
テント	テント ⛺️ 🎪 🏕️
大人	大人 👨 👨‍🦰 👨‍🦱 👨‍🦲 👨‍🦳 👩 👩‍🦰 👩‍🦱 👩‍🦲 👩‍🦳 🧑 🧑‍🦰 🧑‍🦱 🧑‍🦲 🧑‍🦳 🧓
彫像	彫像 🗽
ほろ酔い	ほろ酔い 🥴
えいりょういんどようちいき	えいりょういんどようちいき 🇮🇴
ババ	ババ 🃏
ベビーシート	ベビーシート 🚼️
男の子	男の子 👦 👨‍👦 👨‍👦‍👦 👨‍👧‍👦 👨‍👨‍👦 👨‍👨‍👦‍👦 👨‍👨‍👧‍👦 👨‍👩‍👦 👨‍👩‍👦‍👦 👨‍👩‍👧‍👦 👩‍👦 👩‍👦‍👦 👩‍👧‍👦 👩‍👩‍👦 👩‍👩‍👦‍👦 👩‍👩‍👧‍👦
しおれた花	しおれた花 🥀
バス	バス 🚌 🚍️ 🚎 🚐
じょせいとじょせいできす	じょせいとじょせいできす 👩‍❤️‍💋‍👩
イジェクト	イジェクト ⏏️
くえすちょん	くえすちょん ❓️ ❔️
ひたいにてをあてるおとこ	ひたいにてをあてるおとこ 🤦‍♂️
クマ	クマ 🐻 🐻‍❄️ 🫩
虫眼鏡	虫眼鏡 🔍️
けんきゅう	けんきゅう 🔬
さんざる	さんざる 🙈 🙉 🙊
じょせいのさいばんかん	じょせいのさいばんかん 👩‍⚖️
クモ	クモ 🕷️ 🕸️
こわごわ	こわごわ 🫣 🫣
びたみんＣ	びたみんＣ 🍊
すいきゅうをするおとこ	すいきゅうをするおとこ 🤽‍♂️
まるてぃにーく	まるてぃにーく 🇲🇶
バラ	バラ 🌹
介助犬	介助犬 🐕‍🦺
ごみすてきんし	ごみすてきんし 🚯
むきむき	むきむき 💪
アンデッド	アンデッド 🧟
まらそん	まらそん 🎽 🏃 🏃‍♀️ 🏃‍♀️‍➡️ 🏃‍♂️ 🏃‍♂️‍➡️ 🏃‍➡️
シチュー	シチュー 🍲
まんまーく	まんまーく 🈵
ひらいたふぉるだー	ひらいたふぉるだー 📂
駅弁	駅弁 🍱
すろっとましん	すろっとましん 🎰
7:00	7:00 🕖️ 🕖️
上目	上目 🙄
こんちゅう	こんちゅう 🐜 🦋 🦗 🪲
回転	回転 🪀
ばいばい	ばいばい 👋
てれびげーむ	てれびげーむ 🎮️ 🕹️
ピストル	ピストル 🔫
おどるおとこ	おどるおとこ 🕺
バー	バー 🍷 🍸️ 🍹 🍺 🍻 🍾
白い歯	白い歯 🦷
ケッテイ	ケッテイ 🫏
ごう	ごう 🈴
上着	上着 🥼
ぎょーざ	ぎょーざ 🥟
スター	スター ✨️ ⭐️ 🌟 🌠 👨‍🎤 👩‍🎤 🧑‍🎤
へいあん	へいあん 🧘
きごう	きごう ©️ ®️ ‼️ ⁉️ ™️ ☑️ ✅️ ✔️ ✖️ ✳️ ✴️ ❇️ ❌️ ❎️ ❓️ ❔️ ❕️ ❗️ ➕️ ➖️ ➗️ ➰️ ➿️ ⭕️ 〰️ 〽️ 🔣
飛行機離陸	飛行機離陸 🛫
ごじ	ごじ 🕔️
口なし	口なし 😶
税関	税関 🛃
赤いバラ	赤いバラ 🌹
耳の不自由な女性	耳の不自由な女性 🧏‍♀️
びっくりした顔	びっくりした顔 😲
うもう	うもう 🪶
リズム	リズム 🪇 🪘
くちひげ	くちひげ 🥸
掛け金	掛け金 🪝
RV車	RV車 🚙
半券	半券 🎟️ 🎫
うちき	うちき 🫥
チェック	チェック ☑️ ✅️ ✔️
ぽーく	ぽーく 🐖 🥩
Ｔしゃつ	Ｔしゃつ 👕
ごーすと	ごーすと 👻
キャンディ	キャンディ 🍬 🍭
3時	3時 🕒️
えふで	えふで 🖌️
ぽーず	ぽーず ⏸️
ちゅうしゃき	ちゅうしゃき 💉
ブルーレイ	ブルーレイ 💿️ 📀
ごふ	ごふ 🪬
みずいろ	みずいろ 🩵
みつびん	みつびん 🍯
ケーキ	ケーキ 🍰 🎂 🧁
ぽーち	ぽーち 👝
ふもう｜かんばつ｜はのないき｜ふゆ	ふもう｜かんばつ｜はのないき｜ふゆ 🪾
ごみ	ごみ 🚯 🚯
異性	異性 👫
顔のある新月	顔のある新月 🌚
パスワード	パスワード 🔑 🗝️
うちわ	うちわ 🪭
薪割り	薪割り 🪓
群れ	群れ 🦬
かっぷるとはーと	かっぷるとはーと 👨‍❤️‍👨 👩‍❤️‍👨 👩‍❤️‍👩 💑
7:30	7:30 🕢️ 🕢️
ケール	ケール 🥬
マウンテンバイク	マウンテンバイク 🚵
くうしつ	くうしつ 🈳
まんげつ	まんげつ 🌕️ 🌝
男性宇宙飛行士	男性宇宙飛行士 👨‍🚀
ひらいたじょう	ひらいたじょう 🔓️
くりあ	くりあ 🆑
ふくすうのいえ	ふくすうのいえ 🏘️
インベーダー	インベーダー 👾
ちゃーと	ちゃーと 💹 📈 📉 📊
ほんぱお	ほんぱお 🧧
ぼでぃびる	ぼでぃびる 💪
すいせい	すいせい ☄️
梯子	梯子 🪜
END矢印	END矢印 🔚
放送	放送 📢 📻️
じぇっとこーすたー	じぇっとこーすたー 🎢
にほんちず	にほんちず 🗾
ひつぎ	ひつぎ ⚰️
ブタ鼻	ブタ鼻 🐽
フルート奏者	フルート奏者 🪈
ぷっくっくな顔	ぷっくっくな顔 😡
あはは	あはは 😂 😂 😆 😆 🤣 🤣
ゆると	ゆると 🛖
シェフ	シェフ 👨‍🍳 👩‍🍳 🧑‍🍳
ばってりーざんりょうていか	ばってりーざんりょうていか 🪫
喫茶（コーヒー）	喫茶（コーヒー） ☕️
ひつじ	ひつじ 🐏 🐑 🐑
るーぷ	るーぷ ➰️ ➿️
秀才	秀才 🤓
るーぺ	るーぺ 🔍️ 🔎
けいこく	けいこく ⚠️
えんじぇる	えんじぇる 👼
涼む	涼む 🪭
ブーベ島	ブーベ島 🇧🇻
りさいくる	りさいくる ♻️
しつぼう	しつぼう 🙍
飲料水	飲料水 🚰
ヴィラン	ヴィラン 🦹 🦹‍♀️ 🦹‍♂️
かんぱい	かんぱい 🍻 🥂
おたんじょうび	おたんじょうび 🎂
バイオリン	バイオリン 🎻
シュリンプ	シュリンプ 🦐
せいれい	せいれい 🧞 🧞‍♀️ 🧞‍♂️
だむづくり	だむづくり 🦫
しーっ	しーっ 🤫 🤫
大道芸	大道芸 🤹 🤹‍♀️ 🤹‍♂️
かやっく	かやっく 🚣 🚣‍♀️ 🚣‍♂️ 🛶
医師	医師 👨‍⚕️ 👩‍⚕️ 😷 🧑‍⚕️
しーと	しーと 💺 🪑
おんどり	おんどり 🐓 🐓
男性と女性と男の子の家族	男性と女性と男の子の家族 👨‍👩‍👦
口のない顔	口のない顔 😶
ぱんだのかお	ぱんだのかお 🐼
ディナー	ディナー 🍴 🍽️
ペトリ皿	ペトリ皿 🧫
施錠	施錠 🔒️
ノーフォーク島	ノーフォーク島 🇳🇫
看板	看板 🪧
５じ	５じ 🕔️
めかくし	めかくし 🙈
ねぱーる	ねぱーる 🇳🇵
ふたりできす	ふたりできす 💏
タジキスタン	タジキスタン 🇹🇯
ふるえている	ふるえている 🫨
駆け足	駆け足 🏃 🏃‍♀️ 🏃‍♀️‍➡️ 🏃‍➡️
ジャマイカ	ジャマイカ 🇯🇲
けんない	けんない 📶
かたつむり	かたつむり 🐌 🐌
手（お願い）	手（お願い） 🙏
水球をする女	水球をする女 🤽‍♀️
まにきゅあ	まにきゅあ 💅
せいぶつがくしゃ	せいぶつがくしゃ 🧑‍🔬 🧫 🧬
私立探偵	私立探偵 🕵️ 🕵️‍♀️
ネコ	ネコ 🐈️ 🐈‍⬛ 🐱
くれよん	くれよん 🖍️
backやじるし	backやじるし 🔙
しゃとる	しゃとる 🏸
小エビ	小エビ 🦐
だいびんぐ	だいびんぐ 🤿 🥽 🦪
くちをあけたかお	くちをあけたかお 😦
はいゆう	はいゆう 🎭️ 👨‍🎤 👩‍🎤
ちぇりー	ちぇりー 🍒
しあわせ	しあわせ 🤸 🤸‍♀️ 🤸‍♂️
閉じた傘	閉じた傘 🌂
リピートボタン	リピートボタン 🔁
側転する人	側転する人 🤸
さのまーく	さのまーく 🈂️
かんたんふ	かんたんふ ‼️ ❗️
金髪の男性	金髪の男性 👱‍♂️
シルバー	シルバー 🥈
叫んでいる顔	叫んでいる顔 😱
文具	文具 ✂️ ✏️ ✒️ 📁 📂 📇 📋️ 📌 📍 📎 📏 📐 📑 📒 📓 📔 📝 🖇️ 🖊️ 🖋️ 🖌️ 🖍️ 🗂️ 🗃️ 🗒️
げんしのしんぼる	げんしのしんぼる ⚛️
ユーロ札	ユーロ札 💶
じゃばら	じゃばら 🪗 🪗
まなーもーど	まなーもーど 📳
せんす	せんす 🪭
カラオケ	カラオケ 🎤
4:00	4:00 🕓️ 🕓️
はむさ	はむさ 🪬
わからない	わからない 😕 😕
ぴたぱん	ぴたぱん 🥙 🫓
かなしい	かなしい ☹️ 😔 😞 😟 😢 😭 😿
かげんのつき	かげんのつき 🌗 🌜️
なんきんじょう	なんきんじょう 🔏 🔐 🔒️ 🔓️
パラグライダー	パラグライダー 🪂
こていでんわ	こていでんわ ☎️
せんろ	せんろ 🛤️
犯人	犯人 🦹 🦹‍♀️ 🦹‍♂️
おうしゅうれんごう	おうしゅうれんごう 🇪🇺
女優	女優 🎭️
けが	けが ❤️‍🩹 🤕 🩸 🩸 🩹 🩹 🩼
電池残量低下	電池残量低下 🪫
青ハート	青ハート 💙
開いた本	開いた本 📖
正座する女性	正座する女性 🧎‍♀️ 🧎‍♀️‍➡️
サルサ	サルサ 💃 🕺
えりとりあ	えりとりあ 🇪🇷
じょうようしゃ	じょうようしゃ 🚗 🚘️ 🚙
マーメイド	マーメイド 🧜 🧜‍♀️
ばーさすまーく	ばーさすまーく 🆚
登録商標	登録商標 ®️
タークス・カイコス諸島	タークス・カイコス諸島 🇹🇨
ぎょうざ	ぎょうざ 🥟 🥟
めをとじてべー	めをとじてべー 😝
目をむく	目をむく 🙄
ローションボトル	ローションボトル 🧴
お札	お札 💴 💵 💶 💷 💸
手（Good）	手（Good） 👍️
警官	警官 👮 👮‍♀️ 👮‍♂️
デッドリフト	デッドリフト 🏋️
ハート（ドキドキ）	ハート（ドキドキ） 💗
哺乳類	哺乳類 🫎 🫏
駐車場	駐車場 🅿️
けがない	けがない 🦲
ペパロニ	ペパロニ 🍕
TOP	TOP 🔝
みつばち	みつばち 🐝
UPマーク	UPマーク 🆙
ないているねこ	ないているねこ 😿
青ピーマン	青ピーマン 🫑
エクアドル	エクアドル 🇪🇨
けん	けん ⚔️ 🪯
えんど	えんど 🔚
りまいんだーりぼん	りまいんだーりぼん 🎗️
映画フィルム	映画フィルム 🎞️
かなしみ	かなしみ 🥺
サイクリング	サイクリング 🚲️ 🚴 🚴‍♀️ 🚴‍♂️ 🚵 🚵‍♀️ 🚵‍♂️
つえをついたひと	つえをついたひと 🧑‍🦯 🧑‍🦯‍➡️
アルバ	アルバ 🇦🇼
ちいさいひしがた	ちいさいひしがた 🔸 🔹
けーぶるかー	けーぶるかー 🚠
男性マーク	男性マーク 🚹️
きけん	きけん ☢️ ☣️ ⚠️ ⚡️ 💣️
ちょうしんき	ちょうしんき 🩺
ウィンクする顔	ウィンクする顔 😉
目を閉じてべー	目を閉じてべー 😝
くびまき	くびまき 🧣
警察	警察 👮 👮‍♀️ 👮‍♂️ 🚓 🚔️ 🚨
夜の橋	夜の橋 🌉
かいちゅうでんとう	かいちゅうでんとう 🔦
ひーろー	ひーろー 🦸 🦸‍♀️ 🦸‍♂️
くろいはーと	くろいはーと 🖤
かんきつるい	かんきつるい 🍊 🍋 🍋‍🟩
ねったい	ねったい 🌴 🦩
飲用禁止	飲用禁止 🚱
花火大会	花火大会 🎆
さろん	さろん 💆
ゾンビ	ゾンビ 🧟 🧟‍♀️ 🧟‍♂️
テニスシューズ	テニスシューズ 👟
歌記号（いおり点）	歌記号（いおり点） 〽️
4:30	4:30 🕟️ 🕟️
スケートボード	スケートボード 🛹
虫めがね	虫めがね 🔍️ 🔎 🕵️ 🕵️‍♀️ 🕵️‍♂️
チョコレート	チョコレート 🍫
くびをたてにふる	くびをたてにふる 🙂‍↕️
円高	円高 💹
お得	お得 🉐
つうすいかっぷ	つうすいかっぷ 🪠
テニスボール	テニスボール 🎾
ぶいさいん	ぶいさいん ✌️
カンダ	カンダ 🪯
あづけいれにもつ	あづけいれにもつ 🛄
投票	投票 🗳️
フランス国旗	フランス国旗 🇫🇷
かえってくる	かえってくる 🪃
きたまけどにあ	きたまけどにあ 🇲🇰
ブティック	ブティック 👠
かいしゃ	かいしゃ 🏢
いりょう	いりょう ⚕️ 🩸 🩺
むきりょく	むきりょく 🫤
電動車椅子の人	電動車椅子の人 🧑‍🦼 🧑‍🦼‍➡️
表情（泣き笑い）	表情（泣き笑い） 😂
さんまりの	さんまりの 🇸🇲
男性の整備士	男性の整備士 👨‍🔧
まーめいど	まーめいど 🧜 🧜‍♀️
じぶらるたる	じぶらるたる 🇬🇮
OKのポーズをする男	OKのポーズをする男 🙆‍♂️
なうる	なうる 🇳🇷
くろこだいる	くろこだいる 🐊
頷く	頷く 🙂‍↕️
受話器	受話器 📞
TOP矢印	TOP矢印 🔝
あくやく	あくやく 🦹
えいがかん	えいがかん 🎦
ぐあなこ	ぐあなこ 🦙
みどりのまる	みどりのまる 🟢
男性の教師	男性の教師 👨‍🏫
赤ちょうちん	赤ちょうちん 🏮
new	new 🆕
ひよこまめ	ひよこまめ 🧆
分子	分子 ⚛️
ぐんたい	ぐんたい 🪖 🫡
4時半	4時半 🕟️
ぽけっとべる	ぽけっとべる 📟️
ビクーナ	ビクーナ 🦙
黒四角中	黒四角中 ◾️
12時	12時 🕛️
くんしゅ	くんしゅ 🫅
まーしゃるしょとう	まーしゃるしょとう 🇲🇭
目を細める	目を細める 😊
２じ	２じ 🕑️
だいすき	だいすき 😍
ぷえるとりこ	ぷえるとりこ 🇵🇷
えだまめ	えだまめ 🫛
モロッコ	モロッコ 🇲🇦
くりすます	くりすます 🎄 🎅 🤶 🧑‍🎄
メガネ	メガネ 👓️ 🕶️ 🤓 🥸 🧐
だんせいのせいびし	だんせいのせいびし 👨‍🔧
7じ	7じ 🕖️
ループ	ループ ➰️ ➿️
プロジェクター	プロジェクター 📽️
こごえ	こごえ 🥶
ルーペ	ルーペ 🔍️ 🔎
チョコレートチップ	チョコレートチップ 🍪
化粧	化粧 💄
ススキ	ススキ 🌾 🎑
ナシ	ナシ 🍐
ナス	ナス 🍆
勲章	勲章 🎖️
音量	音量 🔈️ 🔉 🔊
若葉マーク	若葉マーク 🔰
おーすとりあ	おーすとりあ 🇦🇹
十五夜	十五夜 🎑
金メダル	金メダル 🏅 🥇
かわうそ	かわうそ 🦦
１１じ	１１じ 🕚️
ランナー	ランナー 🏃 🏃‍♀️ 🏃‍♀️‍➡️ 🏃‍♂️ 🏃‍♂️‍➡️ 🏃‍➡️
おとぎ話	おとぎ話 🧌 🧚 🧜
シーッ	シーッ 🤫
女性の整備士	女性の整備士 👩‍🔧
ぎふと	ぎふと 🎁
しょうがっこう	しょうがっこう 🎒
グラフ下向き	グラフ下向き 📉
シート	シート 💺 🪑
とりい	とりい ⛩️
かおのあるかげんのつき	かおのあるかげんのつき 🌜️
手動式車椅子	手動式車椅子 🦽
ひだりしたやじるし	ひだりしたやじるし ↙️
ネックレス	ネックレス 📿
ナン	ナン 🫓
くろーばー	くろーばー ☘️ ♣️ 🍀
1:00	1:00 🕐️ 🕐️
じゅにゅうするひと	じゅにゅうするひと 🧑‍🍼
フラミンゴ	フラミンゴ 🦩
ふれんちふらい	ふれんちふらい 🍟
占い	占い 🔮 🔯
びーばー	びーばー 🦫
フロッピー	フロッピー 💾
ぎあ	ぎあ ⚙️
まるた	まるた 🇲🇹 🪵
風呂に入る人	風呂に入る人 🛀
ハロウィン	ハロウィン 🎃
ブータン	ブータン 🇧🇹
ガソリン	ガソリン ⛽️
金持ち	金持ち 💰️
ボートをこぐ人	ボートをこぐ人 🚣
リフト	リフト 🚠 🛗
冷や汗	冷や汗 😅 😓 😰
だんせいのきょうし	だんせいのきょうし 👨‍🏫
ピンク色	ピンク色 🦩
メノラー	メノラー 🕎
まるひ	まるひ ㊙️
母親	母親 👩‍🍼 🧑‍🍼
ＣＯＯＬ	ＣＯＯＬ 🆒
れすりんぐするおとこ	れすりんぐするおとこ 🤼‍♂️
けつえきがた	けつえきがた 🅰️ 🅱️ 🅾️ 🆎
はいひーる	はいひーる 👠
時計（１１時）	時計（１１時） 🕚️
胡坐	胡坐 🧘
みにくいアヒルの子	みにくいアヒルの子 🦢
ごちそう	ごちそう 🍴 🍴
じょせい	じょせい ♀️ ⛹️‍♀️ 🏃‍♀️ 🏃‍♀️‍➡️ 🏄‍♀️ 🏊‍♀️ 🏋️‍♀️ 🏌️‍♀️ 👨‍👩‍👦 👨‍👩‍👦‍👦 👨‍👩‍👧 👨‍👩‍👧‍👦 👨‍👩‍👧‍👧 👩 👩‍⚕️ 👩‍⚖️ 👩‍✈️ 👩‍❤️‍👨 👩‍❤️‍👩 👩‍❤️‍💋‍👨 👩‍❤️‍💋‍👩 👩‍🌾 👩‍🍳 👩‍🍼 👩‍🎓 👩‍🎤 👩‍🎨 👩‍🏫 👩‍🏭 👩‍👦 👩‍👦‍👦 👩‍👧 👩‍👧‍👦 👩‍👧‍👧 👩‍👩‍👦 👩‍👩‍👦‍👦 👩‍👩‍👧 👩‍👩‍👧‍👦 👩‍👩‍👧‍👧 👩‍💻 👩‍💼 👩‍🔧 👩‍🔬 👩‍🚀 👩‍🚒 👩‍🦯 👩‍🦯‍➡️ 👩‍🦰 👩‍🦱 👩‍🦲 👩‍🦳 👩‍🦼 👩‍🦼‍➡️ 👩‍🦽 👩‍🦽‍➡️ 👫 👮‍♀️ 👯‍♀️ 👰‍♀️ 👱‍♀️ 👳‍♀️ 👵 👷‍♀️ 👸 💁‍♀️ 💂‍♀️ 💃 💆‍♀️ 💇‍♀️ 🕵️‍♀️ 🙅‍♀️ 🙆‍♀️ 🙇‍♀️ 🙋‍♀️ 🙍‍♀️ 🙎‍♀️ 🚣‍♀️ 🚴‍♀️ 🚵‍♀️ 🚶‍♀️ 🚶‍♀️‍➡️ 🚺️ 🤦‍♀️ 🤰 🤱 🤵‍♀️ 🤶 🤷‍♀️ 🤸‍♀️ 🤹‍♀️ 🤼‍♀️ 🤽‍♀️ 🤾‍♀️ 🦸‍♀️ 🦹‍♀️ 🧍‍♀️ 🧎‍♀️ 🧎‍♀️‍➡️ 🧏‍♀️ 🧕 🧖‍♀️ 🧗‍♀️ 🧘‍♀️ 🧙‍♀️ 🧚‍♀️ 🧛‍♀️ 🧜‍♀️ 🧝‍♀️ 🧞‍♀️ 🧟‍♀️
株価	株価 💹
かおのあるじょうげんのつき	かおのあるじょうげんのつき 🌛
もーりしゃすとう	もーりしゃすとう 🦤
りゅっくさっく	りゅっくさっく 🎒
とじたゆうびんうけ	とじたゆうびんうけ 📪️ 📫️
11じはん	11じはん 🕦️
モーリシャス	モーリシャス 🇲🇺
かおのあるまんげつ	かおのあるまんげつ 🌝
客船	客船 ⛴️ 🚢 🛳️
女医	女医 👩‍⚕️
オーストラリア	オーストラリア 🇦🇺 🌏️ 🦘 🪃
ふぇいすまっさーじちゅうのおとこ	ふぇいすまっさーじちゅうのおとこ 💆‍♂️
ぎん	ぎん 🥈
知的	知的 🤓
表情（ひえ～）	表情（ひえ～） 😱
しきじょう	しきじょう 💒
板チョコ	板チョコ 🍫
軟体動物	軟体動物 🐙 🦑
男性の裁判官	男性の裁判官 👨‍⚖️
側転する女	側転する女 🤸‍♀️
晴れ	晴れ ☀️ 🌤️
ウイルス	ウイルス 🦟 🦠
あーるぶいしゃ	あーるぶいしゃ 🚙
顎に手	顎に手 🤔
ユーフォー	ユーフォー 👽️
ものぐさ	ものぐさ 🦥 🦥
モーターボート	モーターボート 🚤 🛥️
ぱらせーりんぐ	ぱらせーりんぐ 🪂
きずついた	きずついた ❤️‍🩹
マルティニーク	マルティニーク 🇲🇶
すてっき	すてっき 🩼
不賛成	不賛成 🙂‍↔️
ぱとらんぷ	ぱとらんぷ 🚨
さんりんたくしー	さんりんたくしー 🛺
地震	地震 🫨
緑の四角	緑の四角 🟩
アウター	アウター 🧥
砂時計	砂時計 ⌛️ ⏳️
ドクター	ドクター 👨‍⚕️ 👩‍⚕️ 😷
そーだ	そーだ 🥤
児童横断	児童横断 🚸
ひとさしゆび	ひとさしゆび ☝️
1:30	1:30 🕜️ 🕜️
けっこんしき	けっこんしき 💒
ひだりにむけたて	ひだりにむけたて 🫲
水晶玉	水晶玉 🔮
すてっち	すてっち 🪡
無気力	無気力 🫤
すぱーく	すぱーく ✴️ ❇️
日付	日付 📅 📆 🗓️
トングサンダル	トングサンダル 🩴
なかゆび	なかゆび 🖕
ちぇっく	ちぇっく ☑️ ✅️ ✔️
バルーン	バルーン 🎈
ぴんく	ぴんく 🩷
しまりす	しまりす 🐿️
あいしてる	あいしてる 🤟 🥰 🩷
歩く男	歩く男 🚶‍♂️ 🚶‍♂️‍➡️
ばすけっとぼーるをするひと	ばすけっとぼーるをするひと ⛹️
そーぷ	そーぷ 🧼
ろっくすたー	ろっくすたー 👨‍🎤 👩‍🎤
インドネシア	インドネシア 🇮🇩
アンテナマーク	アンテナマーク 📶
契約成立	契約成立 🤝
商標	商標 ™️
エチオピア	エチオピア 🇪🇹
ちょくじょうぎ	ちょくじょうぎ 📏
abc	abc 🔤
にわとり	にわとり 🐓 🐓 🐔 🐔
ヒンドゥー教の寺院	ヒンドゥー教の寺院 🛕
双子	双子 👬 👯
なざーるぼんじゅう	なざーるぼんじゅう 🧿
さーふぁー	さーふぁー 🏄️ 🏄‍♀️ 🏄‍♂️
二重丸	二重丸 🔘
シント・マールテン	シント・マールテン 🇸🇽
ビルベリー	ビルベリー 🫐
べびーまーく	べびーまーく 🚼️
高齢者	高齢者 👴 👵 🦳 🧓
煮物	煮物 🍲
すこっち	すこっち 🥃
大変よくできました	大変よくできました 💮
放射能	放射能 ☢️
赤くなる	赤くなる 😳
あきれ顔	あきれ顔 😦
こきゅう	こきゅう 🫁
ぶらざびる	ぶらざびる 🇨🇬
女性の裁判官	女性の裁判官 👩‍⚖️
臓器	臓器 🫀 🫁
白十字	白十字 ⛑️
水晶球	水晶球 🔮
れんとげん	れんとげん 🩻
雛祭り	雛祭り 🎎
ダービー	ダービー 🐎
みどりのほん	みどりのほん 📗
さりー	さりー 🥻
上指差し	上指差し ☝️ 👆️
スポンジ	スポンジ 🧽
女性の衛兵	女性の衛兵 💂‍♀️
りんぐめも	りんぐめも 🗒️
ふたご	ふたご 👬 👯
はなたば	はなたば 💐
包帯を巻いた顔	包帯を巻いた顔 🤕
すこっぷ	すこっぷ 🪏
文房具	文房具 ✂️ ✏️ ✒️ 📁 📂 📇 📋️ 📌 📍 📎 📏 📐 📑 📒 📓 📔 📝 🖇️ 🖊️ 🖋️ 🖌️ 🖍️ 🗂️ 🗃️ 🗒️
だぶるるーぷ	だぶるるーぷ ➿️
まるとく	まるとく 🉐
クモの巣	クモの巣 🕸️
がんびあ	がんびあ 🇬🇲
騎手	騎手 🏇
ボルト	ボルト 🔩
じょうりゅうき	じょうりゅうき ⚗️
日の出	日の出 🌄 🌅
6じ30ふん	6じ30ふん 🕡️
パーティーの顔	パーティーの顔 🥳
入学式	入学式 🎒
電車正面	電車正面 🚆
ふたり	ふたり 👥 👫
むーびー	むーびー 🎞️ 🎥 📹️ 📽️
小丸１	小丸１ ⚪️
ひし形	ひし形 💠 🔶 🔷 🔸 🔹
ハンドボールをする人	ハンドボールをする人 🤾
夕暮れの都会	夕暮れの都会 🌆
4じ	4じ 🕓️
お城（日本）	お城（日本） 🏯
ひめくりカレンダー	ひめくりカレンダー 📆
ぱぷりか	ぱぷりか 🫑
ふたば	ふたば 🌱
すぱいだー	すぱいだー 🕷️ 🕸️
ぎんか	ぎんか 🪙
おんなのえるふ	おんなのえるふ 🧝‍♀️
ぎんが	ぎんが 🌌
あくだま	あくだま 🦹
手紙あり	手紙あり 📫️ 📬️
クイーン	クイーン 👸
テディベア	テディベア 🧸
とろぴかるどりんく	とろぴかるどりんく 🍹
うるぐあい	うるぐあい 🇺🇾
ファーティマ	ファーティマ 🪬
ウシ	ウシ 🐂 🐄 🐮
やしのき	やしのき 🌴 🌴
インデックス	インデックス 🗂️
ふるいかぎ	ふるいかぎ 🗝️
とくいげ	とくいげ 😤
明るい	明るい 🔆
ウマ	ウマ 🐎 🐴
デモ	デモ 🪧
消火器	消火器 🧯
チケット・キップ	チケット・キップ 🎫
持ち物	持ち物 ☂️ ☔️ 🌂
平和	平和 ☮️ 🕊️ 😇
しっくい	しっくい 🧱 🧱
ほてる	ほてる 🏨 🏩 🛋️ 🛌 🛎️ 🛏️
恐竜	恐竜 🦕 🦖
おこったかお	おこったかお 😠
飛べない鳥	飛べない鳥 🦤
明るさ	明るさ 🔅 🔆
きたちょうせん	きたちょうせん 🇰🇵
まよけ	まよけ 🧿
本の山	本の山 📚️
すかーふ	すかーふ 🧕 🧣
エルク	エルク 🫎
ちゃぺる	ちゃぺる ⛪️ 💒 🔔
ばいよう	ばいよう 🧫
エルフ	エルフ 🧝 🧝‍♀️ 🧝‍♂️
しんせいじ	しんせいじ 🍼 👨‍🍼 👩‍🍼 👶 🧑‍🍼
ご祝儀	ご祝儀 🧧
二重	二重 ⏫️ ⏬️
かい	かい 🐚 🦪
はいたつ	はいたつ 📦️ 🚚 🛻
かぎ針	かぎ針 🧶
表情（うっしし）	表情（うっしし） 😤
かお	かお ☠️ ☹️ ☺️ 🌚 🌛 🌜️ 🌝 🌞 🌬️ 🎅 🐔 🐗 🐣 🐤 🐦️ 🐧 🐨 🐭 🐮 🐯 🐰 🐱 🐲 🐴 🐵 🐶 🐷 🐸 🐹 🐺 🐻 🐼 🐽 👀 👂️ 👃 👄 👅 👦 👧 👨 👨‍🦰 👨‍🦱 👨‍🦲 👨‍🦳 👩 👩‍🦰 👩‍🦱 👩‍🦲 👩‍🦳 👯 👰 👱 👲 👳 👴 👵 👶 👷 👸 👹 👺 👼 👽️ 👾 👿 💀 💂 💆‍♂️ 💩 🗣️ 🗿 😀 😁 😂 😃 😄 😅 😆 😇 😈 😉 😊 😋 😌 😍 😎 😏 😐️ 😑 😒 😓 😔 😕 😖 😗 😘 😙 😚 😛 😜 😝 😞 😟 😠 😡 😢 😣 😤 😥 😦 😧 😨 😩 😪 😫 😬 😭 😮 😮‍💨 😯 😰 😱 😲 😳 😴 😵 😶 😶‍🌫️ 😷 😸 😹 😺 😻 😼 😽 😾 😿 🙀 🙁 🙂 🙂‍↔️ 🙂‍↕️ 🙃 🙄 🤐 🤑 🤒 🤓 🤔 🤕 🤖 🤗 🤠 🤡 🤢 🤣 🤤 🤥 🤧 🤨 🤩 🤪 🤫 🤬 🤭 🤮 🤯 🥰 🥱 🥲 🥶 🥸 🥹 🥺 🦁 🦄 🦊 🦌 🦍 🦏 🧐 🧑 🧑‍🦰 🧑‍🦱 🧑‍🦲 🧑‍🦳 🧒 🧓 🧔 🧔‍♀️ 🧔‍♂️ 🫠 🫡 🫢 🫣 🫤 🫥 🫨 🫩
じゃぐりんぐをするおんな	じゃぐりんぐをするおんな 🤹‍♀️
にほんのしろ	にほんのしろ 🏯
かき	かき 🦪
あるてぃめっと	あるてぃめっと 🥏
かぎ	かぎ 🔏 🔐 🔑 🔒️ 🔓️ 🗝️ 🧩
かぐ	かぐ 🪑
やしのみ	やしのみ 🥥
かげ	かげ 👤
かご	かご 🧺 🧺
かさ	かさ ☂️ ☔️ ⛱️ 🌂
喫茶店	喫茶店 ☕️
とりのす	とりのす 🪺
手動式車椅子の男性	手動式車椅子の男性 👨‍🦽 👨‍🦽‍➡️
かじ	かじ 🧯
巡礼	巡礼 🕋
かぜ	かぜ 🌬️ 🍃 🎐 😷 🤒 🤧 🪭
はやおくり	はやおくり ⏩️
手をつなぐ2人	手をつなぐ2人 🧑‍🤝‍🧑
かめ	かめ 🏺 🏺 🐢
かも	かも 🦆
トリニダード・トバゴ	トリニダード・トバゴ 🇹🇹
星１	星１ ✳️
空き	空き 🈳
星２	星２ ⭐️
星３	星３ 🌠
かゆ	かゆ 🥣
黒四角大	黒四角大 ◼️
大音量	大音量 🔊
ギニアビサウ	ギニアビサウ 🇬🇼
から	から 🈳
りこう	りこう 🤓
かに	かに 🦀
ごーぐる	ごーぐる 🥽
かね	かね 🔔 🔕
ＡＢＣＤ	ＡＢＣＤ 🔠
１２３４	１２３４ 🔢
かば	かば 🦛
携帯受信	携帯受信 📲
かん	かん 🥫
登山電車	登山電車 🚞
ドキドキ	ドキドキ 💓 💗
かぶ	かぶ 💹
銀メダル	銀メダル 🥈
かべ	かべ 🧱
あまつぶ	あまつぶ ☔️
ばけもの	ばけもの 👹
たべすぎ	たべすぎ 🫃 🫄
国立公園	国立公園 🏞️
かくごおり	かくごおり 🧊
たんてい	たんてい 🕵️ 🕵️‍♀️ 🕵️‍♂️
放心状態	放心状態 😶‍🌫️
どりぶる	どりぶる ⛹️ ⛹️‍♀️
かみ	かみ 💇 📜 🪮
こうきしん	こうきしん 🦝
うちゅうじん	うちゅうじん 👽️ 👾 🛸
かんがえごと	かんがえごと 💭
さゆうやじるし	さゆうやじるし ↔️
マグネット	マグネット 🧲
きゅうきゅう	きゅうきゅう ⛑️
次項有	次項有 ↩️
にんしん	にんしん 🤰 🫃 🫄
肩をすくめる	肩をすくめる 🤷 🤷‍♀️ 🤷‍♂️
応援（メガホン）	応援（メガホン） 📣
そうぎ	そうぎ ⚱️
ボートをこぐ女	ボートをこぐ女 🚣‍♀️
スペースインベーダー	スペースインベーダー 👾
かいけい	かいけい 🧾
1じはん	1じはん 🕜️
そふとどりんく	そふとどりんく 🥤
さそり座	さそり座 ♏️ 🦂
にじゅう	にじゅう ⏫️ ⏬️
ふきだし	ふきだし 👁️‍🗨️ 💬 💭 🗨️ 🗯️
そうじ	そうじ 🧹 🧽
ミートソース	ミートソース 🍝
たつおとこ	たつおとこ 🧍‍♂️
写真	写真 📷️ 📸
君主	君主 🫅
じゅしんする	じゅしんする 📨
あるくおんな	あるくおんな 🚶‍♀️ 🚶‍♀️‍➡️
10:00	10:00 🕙️ 🕙️
たーばん	たーばん 👳 👳‍♀️ 👳‍♂️
ショベル	ショベル 🪏
女の精霊	女の精霊 🧞‍♀️
カレーライス	カレーライス 🍛
青の本	青の本 📘
電話	電話 ☎️ 📞 📠 📲 🤙
うたきごう	うたきごう 〽️
かおのあるかぜ	かおのあるかぜ 🌬️
大工	大工 🪚
料理人	料理人 👨‍🍳 👩‍🍳
スマイルフェイス	スマイルフェイス ☺️
宇宙	宇宙 ☄️ 🌌 🌑 🌒 🌓 🌔 🌕️ 🌖 🌗 🌘 🌙 🌠 🚀 🛰️ 🛸
閉じた郵便受け	閉じた郵便受け 📪️ 📫️
さようなら	さようなら 👋 👋 🫂 🫂
ずっ友	ずっ友 👯
みつあなぐま	みつあなぐま 🦡
あくせしびりてぃ	あくせしびりてぃ 🐕‍🦺 👨‍🦯 👨‍🦯‍➡️ 👨‍🦼 👨‍🦼‍➡️ 👨‍🦽 👨‍🦽‍➡️ 👩‍🦯 👩‍🦯‍➡️ 👩‍🦼 👩‍🦼‍➡️ 👩‍🦽 👩‍🦽‍➡️ 🛗 🦮 🦯 🦻 🦼 🦽 🦾 🦿 🧏 🧏‍♀️ 🧏‍♂️ 🧑‍🦯 🧑‍🦯‍➡️ 🧑‍🦼 🧑‍🦼‍➡️ 🧑‍🦽 🧑‍🦽‍➡️
ばぬあつ	ばぬあつ 🇻🇺
女性と女性と男の子の家族	女性と女性と男の子の家族 👩‍👩‍👦
書籍	書籍 📕 📖 📗 📘 📙 📚️
あんてなまーく	あんてなまーく 📶
へらじか	へらじか 🫎
きりばす	きりばす 🇰🇮
かのう	かのう 🉑
輝き	輝き 🌟
きいろのはーと	きいろのはーと 💛
目にクマがある顔	目にクマがある顔 🫩
銀河	銀河 🌌
機長	機長 🧑‍✈️
おーとりくしゃー	おーとりくしゃー 🛺
リボンがけのハート	リボンがけのハート 💝
耳の不自由な男性	耳の不自由な男性 🧏‍♂️
かぼちゃ	かぼちゃ 🎃 🎃
ミュート	ミュート 🔇 🔕
きんぱつのだんせい	きんぱつのだんせい 👱‍♂️
1い	1い 🥇
合マーク	合マーク 🈴
天体観測	天体観測 🔭
とうひょう	とうひょう 🗳️
かわせ	かわせ 💹
走る人	走る人 🏃 🏃‍➡️
サンピエール島・ミクロン島	サンピエール島・ミクロン島 🇵🇲
リマインダー	リマインダー 🎗️
メール送信（ポスト）	メール送信（ポスト） 📮
少しだけ	少しだけ 🤏
ちゅーりっぷ	ちゅーりっぷ 🌷
ぼうつききゃんでぃ	ぼうつききゃんでぃ 🍭
スコア	スコア 🎼
ねこのかお	ねこのかお 🐱
1じ	1じ 🕐️
ぶたいげいじゅつ	ぶたいげいじゅつ 🎭️
振りかけ容器	振りかけ容器 🧂
あくびした顔	あくびした顔 🥱
てでぃべあ	てでぃべあ 🧸
けんちく	けんちく 🏗️ 🚩
終わり	終わり 🔚
なんてこった	なんてこった 🫨 🫨
ずぼん	ずぼん 👖
マン島	マン島 🇮🇲
むせん	むせん 🛜
10:30	10:30 🕥️ 🕥️
残念	残念 😞
ラグビーボール	ラグビーボール 🏉
ねじ回し	ねじ回し 🪛
バリヤフリー	バリヤフリー ♿️
ハート５（矢がささっている）	ハート５（矢がささっている） 💘
ひらめき	ひらめき 💡 💡
お手入れ	お手入れ 🪥
おーすとらりあ	おーすとらりあ 🇦🇺 🌏️ 🦘 🪃
チューリップ	チューリップ 🌷
キウイ	キウイ 🥝
上矢印１	上矢印１ ⬆️
上矢印２	上矢印２ ↖️
けっこん	けっこん 👰 💒 🤵
エンジェル	エンジェル 👼
リサイクル	リサイクル ♻️
サモア	サモア 🇼🇸
レシート	レシート 🧾
しんかんせん	しんかんせん 🚄 🚅
上ボタン	上ボタン 🔼
らっこ	らっこ 🦦
えい	えい 🈺
首を振る	首を振る 🙂‍↔️ 🙂‍↕️
ベルギー	ベルギー 🇧🇪
紙と鉛筆	紙と鉛筆 📝
指でOK	指でOK 👍️
えき	えき 🚉
抱擁	抱擁 🫂
こんぱす	こんぱす 🧭
せりふ	せりふ 💬 🗨️
しゅつにゅうこくしんさ	しゅつにゅうこくしんさ 🛂
舞台芸術	舞台芸術 🎭️
缶詰	缶詰 🥫
ワンピース	ワンピース 👗
らっと	らっと 🐀
タキシードの男	タキシードの男 🤵‍♂️
ハンドボールをする女	ハンドボールをする女 🤾‍♀️
セキュリティ	セキュリティ 🔐 🪪
わんぴーすのみずぎ	わんぴーすのみずぎ 🩱
ＵＳＡ	ＵＳＡ 🇺🇸
らっぱ	らっぱ 🎺 📯
NGマーク	NGマーク 🆖
ふうりん	ふうりん 🎐
UFO	UFO 👽️ 🛸
とっぷ	とっぷ 🔝
かたをすくめる	かたをすくめる 🤷 🤷‍♀️ 🤷‍♂️
じゅうりょうあげ	じゅうりょうあげ 🏋️
えと	えと 🐭 🐮 🐯 🐰 🐲
バックパック	バックパック 🎒
うさぎ	うさぎ 🐇 🐇 🐰 🐰
シャッフルボタン	シャッフルボタン 🔀
ぐりーんぴーす	ぐりーんぴーす 🫛
きんしゃさ	きんしゃさ 🇨🇩
えん	えん ⭕️ 💱 💴 💹
原付	原付 🛵
えび	えび 🍤 🦐
ビジネス（ネクタイ）	ビジネス（ネクタイ） 👔
にやっと笑う猫	にやっと笑う猫 😸
すくーるばす	すくーるばす 🚌
ふきげんなおんな	ふきげんなおんな 🙎‍♀️
ゆびはーと	ゆびはーと 🫰
平謝り	平謝り 🙇
突風	突風 🌪️
ほいくえん	ほいくえん 📛
はーとにりぼん	はーとにりぼん 💝
すぷーん	すぷーん 🥄
コートジボワール	コートジボワール 🇨🇮
ロープウェイ	ロープウェイ 🚡
じゅう	じゅう 🔫
手荷物	手荷物 🛄 🛅
イスラム教	イスラム教 ☪️ 🕋 🕌
あかぴーまん	あかぴーまん 🫑
ティラノサウルス	ティラノサウルス 🦖
付箋	付箋 📑 🔖
けいたいでんわでんげんおふ	けいたいでんわでんげんおふ 📴
受ける	受ける 🫴
フロッピーディスク	フロッピーディスク 💾
けいたいでんわきんし	けいたいでんわきんし 📵
じょさん	じょさん ➗️
右下矢印	右下矢印 ↘️
じょうだん	じょうだん 😜
しゅどうしきくるまいすのじょせい	しゅどうしきくるまいすのじょせい 👩‍🦽 👩‍🦽‍➡️
じゅず	じゅず 📿
ジャー	ジャー 🫙
むかんじょう	むかんじょう 😑
ギョーザ	ギョーザ 🥟
モルタル	モルタル 🧱
ていしぼたん	ていしぼたん ⏹️
牝牛	牝牛 🐄
ほっとどりんく	ほっとどりんく ☕️
ランニング	ランニング 🎽 🏃 🏃‍♀️ 🏃‍♀️‍➡️ 🏃‍♂️ 🏃‍♂️‍➡️ 🏃‍➡️
チキン	チキン 🍗
あっぷるぱい	あっぷるぱい 🥧
さいくろん	さいくろん 🌀
ふらふらのかお	ふらふらのかお 🥴
紙手提げ	紙手提げ 🛍️
むっとしている人	むっとしている人 🙍
ロケット	ロケット 🚀 🧑‍🚀
なまけもの	なまけもの 🦥
みぎ	みぎ ↪️ ⏩️ ➡️ 👉️ 🤜
熱を測る	熱を測る 🤒
モバイル	モバイル 📱 📲
拳銃	拳銃 🔫
ぶろっこりー	ぶろっこりー 🥦
あっぷ	あっぷ 🆙
みず	みず 💧 🚰 🥤 🫗
みせ	みせ 🏪
笑う	笑う 😀 😁 😂 😸 🤣
フィールドホッケー	フィールドホッケー 🏑
だんせいのえいへい	だんせいのえいへい 💂‍♂️
ねじまわし	ねじまわし 🪛
男性消防士	男性消防士 👨‍🚒
じゃぐりんぐ	じゃぐりんぐ 🤹 🤹‍♀️ 🤹‍♂️
まきもどし	まきもどし ⏪️ ◀️
あついかお	あついかお 🥵
ストローカップ	ストローカップ 🥤
にゅー	にゅー 🆕
ポンド札	ポンド札 💷
すけーと	すけーと ⛸️ 🛼
フライドポテト	フライドポテト 🍟
はちかくけい	はちかくけい 🛑
正座する男性	正座する男性 🧎‍♂️ 🧎‍♂️‍➡️
びっくり	びっくり ❕️ 😯 😯 😲 😲 🙀 🙀 🙆 🙆 🤯 🤯 🫢 🫢 🫨
だんせいうちゅうひこうし	だんせいうちゅうひこうし 👨‍🚀
フタコブラクダ	フタコブラクダ 🐫
6時30分	6時30分 🕡️
かれき	かれき 🪾
マップ	マップ 🗺️
パドル	パドル 🚣
スマイリー	スマイリー ☺️
はしるおとこ	はしるおとこ 🏃‍♂️ 🏃‍♂️‍➡️
料理	料理 🍳 👨‍🍳 👩‍🍳 🔪 🧑‍🍳
連符	連符 🎵
クジャク	クジャク 🦚
黒四角小	黒四角小 ▪️
トルネード	トルネード 🌪️
女性と男の子と男の子の家族	女性と男の子と男の子の家族 👩‍👦‍👦
女性マーク	女性マーク 🚺️
かにざ	かにざ ♋️
じょせいのいしゃ	じょせいのいしゃ 👩‍⚕️
みぎしたやじるし	みぎしたやじるし ↘️
座る	座る 🧎 🧎‍♀️ 🧎‍♀️‍➡️ 🧎‍♂️ 🧎‍♂️‍➡️ 🧎‍➡️
女性	女性 ♀️ ⛹️‍♀️ 🏃‍♀️ 🏃‍♀️‍➡️ 🏄‍♀️ 🏊‍♀️ 🏋️‍♀️ 🏌️‍♀️ 👨‍👩‍👦 👨‍👩‍👦‍👦 👨‍👩‍👧 👨‍👩‍👧‍👦 👨‍👩‍👧‍👧 👩 👩‍⚕️ 👩‍⚖️ 👩‍✈️ 👩‍❤️‍👨 👩‍❤️‍👩 👩‍❤️‍💋‍👨 👩‍❤️‍💋‍👩 👩‍🌾 👩‍🍳 👩‍🍼 👩‍🎓 👩‍🎤 👩‍🎨 👩‍🏫 👩‍🏭 👩‍👦 👩‍👦‍👦 👩‍👧 👩‍👧‍👦 👩‍👧‍👧 👩‍👩‍👦 👩‍👩‍👦‍👦 👩‍👩‍👧 👩‍👩‍👧‍👦 👩‍👩‍👧‍👧 👩‍💻 👩‍💼 👩‍🔧 👩‍🔬 👩‍🚀 👩‍🚒 👩‍🦯 👩‍🦯‍➡️ 👩‍🦰 👩‍🦱 👩‍🦲 👩‍🦳 👩‍🦼 👩‍🦼‍➡️ 👩‍🦽 👩‍🦽‍➡️ 👫 👮‍♀️ 👯‍♀️ 👰‍♀️ 👱‍♀️ 👳‍♀️ 👵 👷‍♀️ 👸 💁‍♀️ 💂‍♀️ 💃 💆‍♀️ 💇‍♀️ 🕵️‍♀️ 🙅‍♀️ 🙆‍♀️ 🙇‍♀️ 🙋‍♀️ 🙍‍♀️ 🙎‍♀️ 🚣‍♀️ 🚴‍♀️ 🚵‍♀️ 🚶‍♀️ 🚶‍♀️‍➡️ 🚺️ 🤦‍♀️ 🤰 🤱 🤵‍♀️ 🤶 🤷‍♀️ 🤸‍♀️ 🤹‍♀️ 🤼‍♀️ 🤽‍♀️ 🤾‍♀️ 🦸‍♀️ 🦹‍♀️ 🧍‍♀️ 🧎‍♀️ 🧎‍♀️‍➡️ 🧏‍♀️ 🧕 🧖‍♀️ 🧗‍♀️ 🧘‍♀️ 🧙‍♀️ 🧚‍♀️ 🧛‍♀️ 🧜‍♀️ 🧝‍♀️ 🧞‍♀️ 🧟‍♀️
バス正面	バス正面 🚍️
医療	医療 ⚕️ 🩸 🩺
ねつがあるかお	ねつがあるかお 🤒
ビーチサンダル	ビーチサンダル 🩴
みみ	みみ 👂️ 🦻
チッ	チッ 🫦
かんづめ	かんづめ 🥫
映画（カメラ）	映画（カメラ） 🎥
ぼすにあへるつぇごびな	ぼすにあへるつぇごびな 🇧🇦
表情（怒り）	表情（怒り） 😡
電話の合図	電話の合図 🤙
口を開けた顔	口を開けた顔 😦
ロウソク	ロウソク 🕯️
にっぽん	にっぽん 🇯🇵
スパイ	スパイ 🕵️ 🥷
電気工	電気工 👨‍🔧 👩‍🔧
ニット	ニット 🧶
かれは	かれは 🍂
ぱらしゅーと	ぱらしゅーと 🪂
スパナ	スパナ 👨‍🔧 👩‍🔧 🔧 🛠️ 🧑‍🔧
キラキラ	キラキラ ✨️ ❇️ 🌟 💖 💫 🪩
困った	困った ☹️ 😖 😟 😥 🙁
かんがるー	かんがるー 🦘
バーレーン	バーレーン 🇧🇭
くちをとがらせたひと	くちをとがらせたひと 🙎
でびる	でびる 👿 😈
ふらっしゅをたいているかめら	ふらっしゅをたいているかめら 📸
祈り	祈り 🙏 🛐 🤲
祈る	祈る 📿
ぱもーにゃ	ぱもーにゃ 🫔
米領ヴァージン諸島	米領ヴァージン諸島 🇻🇮
ガソリンノズル	ガソリンノズル ⛽️
まうんてんばいく	まうんてんばいく 🚵
ハッピーバースデー	ハッピーバースデー 🎂 🥳
きょうかい	きょうかい ⛪️ 💒 🔔
チリ	チリ 🇨🇱
すいじょうきょうぎ	すいじょうきょうぎ 🤽 🤽‍♀️ 🤽‍♂️
ときめき	ときめき 💗 💗
にゅうじょうぱす	にゅうじょうぱす 🎟️
11時半	11時半 🕦️
すいきゅうをするひと	すいきゅうをするひと 🤽
クスクス	クスクス 🤭
丸秘	丸秘 ㊙️
スーダン	スーダン 🇸🇩
うんてんめんきょしょう	うんてんめんきょしょう 🪪
キツネ	キツネ 🤘 🦊
うなずく	うなずく 🙂‍↕️
atm	atm 🏧
おらんだりょうかりぶ	おらんだりょうかりぶ 🇧🇶
ぎゅうにゅう	ぎゅうにゅう 🥛
しんぼるがくちにあるかお	しんぼるがくちにあるかお 🤬
表情（ウィンク）	表情（ウィンク） 😉
こんわく	こんわく 😕 😖 🫤
あるぱか	あるぱか 🦙
申請	申請 🈸
髪を振り払う	髪を振り払う 💁
ふくごうき	ふくごうき 📠 🖨️
おじぎするおとこ	おじぎするおとこ 🙇‍♂️
テントウムシ	テントウムシ 🐞
お巡りさん	お巡りさん 👮 👮‍♀️ 👮‍♂️
レタス	レタス 🥬
ながれぼし	ながれぼし 🌃 🌠 💫
原子のシンボル	原子のシンボル ⚛️
走る女	走る女 🏃‍♀️ 🏃‍♀️‍➡️
両手のひら	両手のひら 👐
就寝中	就寝中 💤 🛌
怒り（ムカッ）	怒り（ムカッ） 💢
おいで	おいで 🫴 🫴
ほうたい	ほうたい ❤️‍🩹 🤕
おいる	おいる 🛢️ 🪔
フロッピー２	フロッピー２ 💽
きょうかん	きょうかん 😮
二重感嘆符	二重感嘆符 ‼️
どきゅめんと	どきゅめんと 📃 📄
こうしょさぎょう	こうしょさぎょう 🪜
インド	インド 🇮🇳
かれー	かれー 🍛
中性的	中性的 🧑 🧑‍🦰 🧑‍🦱 🧑‍🦲 🧑‍🦳 🧒 🧓
黄色い丸	黄色い丸 🟡
ふさんせい	ふさんせい 🙂‍↔️
白衣	白衣 🥼
お皿	お皿 🍽️
もやもや	もやもや 🌀 🌀
日の丸	日の丸 🎌
でんとう	でんとう 🔦
じっけん	じっけん ⚖️ ⚗️ 🔬 🥼 🧪 🧫
ごみばこ	ごみばこ 🗑️ 🚮
ブラキオサウルス	ブラキオサウルス 🦕
にもつ	にもつ 📦️
了解	了解 👍️ 🫡
くしゃみするかお	くしゃみするかお 🤧
ぱらお	ぱらお 🇵🇼
にもの	にもの 🍲
フィンランド	フィンランド 🇫🇮
おうしざ	おうしざ ♉️ 🐂
10じ	10じ 🕙️
まいほーむ	まいほーむ 🏠️ 🏡
パン屋	パン屋 🥯
手の甲	手の甲 🤚
サウスジョージア・サウスサンドウィッチ諸島	サウスジョージア・サウスサンドウィッチ諸島 🇬🇸
れもん	れもん 🍋
ちょうしょく	ちょうしょく 🍳 🍴 🥣 🥯 🧇
放射線	放射線 ☢️
しじゅつ	しじゅつ 💆
まげたあし	まげたあし 🦵
らいふせーばー	らいふせーばー 🛟
ストライク	ストライク 🎳
ぴっころ	ぴっころ 🪈
のりもの	のりもの ⛴️ ⛵️ ✈️ 🏍️ 🏎️ 🚀 🚁 🚂 🚃 🚄 🚅 🚆 🚇️ 🚈 🚉 🚊 🚋 🚌 🚍️ 🚎 🚏 🚐 🚑️ 🚒 🚓 🚔️ 🚕 🚖 🚗 🚘️ 🚙 🚚 🚛 🚜 🚝 🚞 🚟 🚠 🚡 🚢 🚤 🚲️ 🛥️ 🛩️ 🛫 🛬 🛳️ 🛶 🛸 🛻
しょうはい	しょうはい 🏆️
アルジェリア	アルジェリア 🇩🇿
エスオーエス	エスオーエス 🆘
フリーダイヤル	フリーダイヤル ➿️
どるぶくろ	どるぶくろ 💰️
トランスジェンダーフラッグ	トランスジェンダーフラッグ 🏳️‍⚧️
ニューヨーク	ニューヨーク 🗽
やまをのぼるひと	やまをのぼるひと 🧗
おひつじざ	おひつじざ ♈️ 🐏
書いている手	書いている手 ✍️
男性と女の子の家族	男性と女の子の家族 👨‍👧
きゃっしゅ	きゃっしゅ 💰️
ステーキ	ステーキ 🥩
クジラ	クジラ 🐋 🐳
小さい青のひし形	小さい青のひし形 🔹
道路	道路 ⛔️ 🚫 🚳 🚷 🛣️
かいぞくき	かいぞくき 🏴‍☠️
がーりっく	がーりっく 🧄
ビスク	ビスク 🦞
していせき	していせき 🈯️
便器	便器 🚽
8分音符	8分音符 🎵 🎶
ぼき	ぼき 🧾
山を登る人	山を登る人 🧗
10じ30ふん	10じ30ふん 🕥️
OKマーク	OKマーク 🆗
キャラクター（かわいく怒る）	キャラクター（かわいく怒る） 🙎
ニュース	ニュース 📰 🗞️
医者	医者 ⚕️ 🏥 👨‍⚕️ 👩‍⚕️ 💉 💊 🥼 🧑‍⚕️ 🩸 🩺 🩻
われたはーと	われたはーと 💔
アイディー	アイディー 🆔
すけるとん	すけるとん 🛷
まいった	まいった 🫨 🫨
ぼち	ぼち 🪦
立つ人	立つ人 🧍
タコス	タコス 🌮
口を尖らせた人	口を尖らせた人 🙎
吐き気を催している顔	吐き気を催している顔 🤢
ぼつ	ぼつ 🆖 👎️
がいこつ	がいこつ ☠️ 💀
からい	からい 🌶️
カフェイン	カフェイン ☕️
ランドセル	ランドセル 🎒
出血	出血 🩸
ちょっき	ちょっき 🦺
べるしょうおん	べるしょうおん 🔕
ボックス	ボックス 🗃️
ふざけ	ふざけ 🤪 🤪
タイガー	タイガー 🐅
でんげんおふ	でんげんおふ 📴
10時30分	10時30分 🕥️
わっか	わっか ➰️ ➿️
くす玉	くす玉 🎊
ぷりんす	ぷりんす 🤴
あくしゅ	あくしゅ 🤝 🫱 🫲
18禁	18禁 🔞
きこえない	きこえない 🧏
からす	からす 🐦‍⬛
ぷりんた	ぷりんた 🖨️
えんかい	えんかい 🍻
みやまがらす	みやまがらす 🐦‍⬛
もどる	もどる ⏪️ ◀️ 🔙
葉野菜	葉野菜 🥬
汽車	汽車 🚂
からだ	からだ 👀 👀 👁️ 👁️ 👂️ 👂️ 👃 👃 👄 👄 👅 👅
ろっかー	ろっかー 🛅 🧑‍🎤
切る	切る ✂️ 🪚
てこぎぼーと	てこぎぼーと 🚣 🚣‍♀️
たいほする	たいほする 👮
ちょっと	ちょっと 🤏 🤏
からて	からて 🥋
ろくが	ろくが ⏺️ 📹️
電車	電車 🚃 🚄 🚅 🚆 🚇️ 🚈 🚉 🚊 🚋 🚝 🚞 🚟
指差し(下）	指差し(下） 👇️
そふぁとらんぷ	そふぁとらんぷ 🛋️
フットボール	フットボール 🏈
芋虫	芋虫 🐛
イタリア	イタリア 🇮🇹
のっと	のっと 🪢
気候変動	気候変動 🪸
ろくじ	ろくじ 🕕️
まらかす	まらかす 🪇
すぽーく	すぽーく 🛞
下弦の月	下弦の月 🌗 🌜️
触手	触手 🪼
かみぶくろ	かみぶくろ 🛍️
ゆうげん	ゆうげん 🈶
大笑い	大笑い 😂
疑問符	疑問符 ❓️ ❔️ ❕️
ばるかんさいん	ばるかんさいん 🖖
男性と男性と男の子と男の子の家族	男性と男性と男の子と男の子の家族 👨‍👨‍👦‍👦
スノボ	スノボ 🏂️
学校	学校 🎒 🏫 📔 📚️
シンボル	シンボル ♀️ ♂️ ⚧️
けんせつ	けんせつ 🏗️ 👷 👷‍♀️ 👷‍♂️
ターバンの女性	ターバンの女性 👳‍♀️
ずるがしこい	ずるがしこい 🦝
しんごう	しんごう 🚥 🚦
すぽーつ	すぽーつ ⚽️ ⚾️ ⛳️ ⛷️ ⛸️ ⛹️ ⛹️‍♀️ ⛹️‍♂️ 🎣 🎯 🎱 🎳 🎽 🎾 🎿 🏀 🏁 🏂️ 🏃 🏄️ 🏄‍♀️ 🏄‍♂️ 🏅 🏇 🏈 🏉 🏊️ 🏊‍♀️ 🏊‍♂️ 🏋️ 🏋️‍♀️ 🏋️‍♂️ 🏌️ 🏌️‍♀️ 🏌️‍♂️ 🏍️ 🏎️ 🏏 🏐 🏑 🏒 🏓 🏸 🚣 🚣‍♀️ 🚣‍♂️ 🚩 🚴 🚴‍♀️ 🚴‍♂️ 🚵 🚵‍♀️ 🚵‍♂️ 🛷 🛼 🤸 🤸‍♀️ 🤸‍♂️ 🤺 🤼 🤼‍♀️ 🤼‍♂️ 🤽 🤽‍♀️ 🤽‍♂️ 🤾 🤾‍♀️ 🤾‍♂️ 🤿 🥅 🥊 🥋 🥌 🥍 🥎
乾杯	乾杯 🍻 🥂
きんまーく	きんまーく 🈲
十三夜月	十三夜月 🌔
ぷれい	ぷれい ▶️
モノづくり	モノづくり 🧑‍🏭
サイレン	サイレン 🚨 🧜
りぴーとぼたん	りぴーとぼたん 🔁
富士山	富士山 🗻
かみをかきあげる	かみをかきあげる 💁
眺め	眺め 🪟
卵からかえったひよこ	卵からかえったひよこ 🐣
剃刀	剃刀 🪒
ちゅうしゅうせつ	ちゅうしゅうせつ 🥮
こえび	こえび 🦐
かんぼじあ	かんぼじあ 🇰🇭
あい	あい ❤️ ❤️‍🔥 💛 💜 🩵 🩶 🩷 🪉 🫰 🫶
さいえんす	さいえんす 🔬 🔭
2にんのしるえっと	2にんのしるえっと 👥
あすれちっくしゅーず	あすれちっくしゅーず 👟
新聞紙	新聞紙 📰 🗞️
スキー	スキー ⛷️ 🎿
あお	あお 💙 🔵 🔷 🔹 🟦 🥶 🧿
あか	あか ❤️ 🔴 🔺 🔻 🟥
台風	台風 🌀
ばれんたいんでー	ばれんたいんでー 💌 💝
リングメモ	リングメモ 🗒️
難聴	難聴 🦻
あき	あき 🈳 🥮 🪽 🫙
てぶくろ	てぶくろ 🧤
あく	あく 🦹 🦹‍♀️ 🦹‍♂️
風に揺れる葉	風に揺れる葉 🍃
香り	香り 🧄
ビーンズ	ビーンズ 🫘
あさ	あさ 🌄 🌅
いたりありょうり	いたりありょうり 🍝
ねずみとり	ねずみとり 🪤
ビル群	ビル群 🏙️
あし	あし 👣 🦵 🦶 🦿
頭痛	頭痛 😓 😣
フェンシング	フェンシング 🤺
ラーテル	ラーテル 🦡
ばぶるてぃー	ばぶるてぃー 🧋
あせ	あせ 💦 💧 😅 😓 😥 😰 🥵
すいちゅう	すいちゅう 🫧
老人	老人 👴 👵 🦳 🧓
マンゴー	マンゴー 🥭
あめ	あめ ☂️ ☔️ ⛈️ ⛱️ 🌂 🌧️ 🍬 🍬 🍭 🍭
親指と人差し指をクロス	親指と人差し指をクロス 🫰
上下矢印	上下矢印 ↕️
O型	O型 🅾️
身だしなみ	身だしなみ 🪞
じどうおうだん	じどうおうだん 🚸
くろしかくちゅう	くろしかくちゅう ◾️
サボテンのある砂漠	サボテンのある砂漠 🏜️
あり	あり 🐜 🐜
あな	あな 🕳️ 🪏
再生ボタン	再生ボタン ▶️
ふぉーちゅんくっきー	ふぉーちゅんくっきー 🥠
双子座	双子座 ♊️
あわ	あわ 🍾 🧼 🫧
ピッツァ	ピッツァ 🍕
ウルグアイ	ウルグアイ 🇺🇾
ボスニア・ヘルツェゴビナ	ボスニア・ヘルツェゴビナ 🇧🇦
嬉し泣き	嬉し泣き 😂 🥹
てをあげるおんな	てをあげるおんな 🙋‍♀️
星と三日月	星と三日月 ☪️
ちちおや	ちちおや 👨‍🍼 🧑‍🍼
ぺろり	ぺろり 😋 😋
謝罪	謝罪 🙇
黒ハート	黒ハート ❤️
チェア	チェア 🪑
黒い丸	黒い丸 ⚫️
ぱれすちなじちく	ぱれすちなじちく 🇵🇸
にんぎょ	にんぎょ 🧜 🧜‍♀️ 🧜‍♂️
ルクセンブルク	ルクセンブルク 🇱🇺
あおのほん	あおのほん 📘
さそり	さそり 🦂
1じ30ふん	1じ30ふん 🕜️
再生	再生 ⏯️ ▶️ ♻️ 🐦‍🔥
どきどきするはーと	どきどきするはーと 💓
刃物	刃物 🪒
すいぎゅう	すいぎゅう 🐃
わかりません	わかりません 🤷 🤷 🤷‍♀️ 🤷‍♀️ 🤷‍♂️ 🤷‍♂️
けにあ	けにあ 🇰🇪
チェコ	チェコ 🇨🇿
ぷっしゅほん	ぷっしゅほん ☎️
チェス	チェス ♟️
トロール	トロール 🧌
ふくれる	ふくれる 🙎 🙎
さしだす	さしだす 🫴
とじたかさ	とじたかさ 🌂
矢印上下	矢印上下 ↕️
危険	危険 ☢️ ☣️ ⚡️ 💣️
いんようふか	いんようふか 🚱
バブル	バブル 🫧
さーふぃんするおとこ	さーふぃんするおとこ 🏄‍♂️
アラブ首長国連邦	アラブ首長国連邦 🇦🇪
せうた・めりりゃ	せうた・めりりゃ 🇪🇦
かちほこったかお	かちほこったかお 😤
飛行機	飛行機 ✈️ 🛩️ 🛫 🛬
かがやき	かがやき 🌟
無感情	無感情 😑
曲線	曲線 ↩️ ↪️ ⤴️ ⤵️
絵の具パレット	絵の具パレット 🎨
すぺいん	すぺいん 🇪🇸
ゆうぐれのとかい	ゆうぐれのとかい 🌆
卓球	卓球 🏓
お腹	お腹 🫄
小銭入れ	小銭入れ 👛
うっしっし	うっしっし 😁
パエリア	パエリア 🥘
銀色	銀色 🩶
原子	原子 ⚛️
割り算	割り算 ➗️
てをかえしているひと	てをかえしているひと 💁
うがんだ	うがんだ 🇺🇬
newまーく	newまーく 🆕
すいーつ	すいーつ 🍦 🍧 🍨 🍩 🍪 🍫 🍮 🍰 🎂 🧁
きんしされた	きんしされた 🙅
グッド	グッド 👍️
たじきすたん	たじきすたん 🇹🇯
おまつり	おまつり 🎆 🎇
クラッカー	クラッカー 🎉
かけあし	かけあし 🏃 🏃‍♀️ 🏃‍♀️‍➡️ 🏃‍➡️
ねずみのかお	ねずみのかお 🐭
しにそう	しにそう 🥵
しょっぴんぐかーと	しょっぴんぐかーと 🛒
驚愕	驚愕 😲
うえきばち	うえきばち 🪴
パック	パック 🏒 🧚
べっどにねるひと	べっどにねるひと 🛌
じょうしょう	じょうしょう 📈
めがほしのえがお	めがほしのえがお 🤩
ささかざり	ささかざり 🎋
しーくきょう	しーくきょう 🪯
ちょう	ちょう 🦋
牛乳入りのコップ	牛乳入りのコップ 🥛
ボート(船）	ボート(船） ⛵️
モニター	モニター 🖥️
ちてき	ちてき 🤓
ちょき	ちょき ✌️
しゅっけつ	しゅっけつ 🩸
きんきゅう	きんきゅう 🚨 🦺
グアム	グアム 🇬🇺
ちょこ	ちょこ 🍫 🍶 🫕
ゴミ捨て	ゴミ捨て 🚮
べる	べる 🔔 🛎️
べろ	べろ 👅 👅 😛 😛 😝 😝 🤑 🤑
歩行補助	歩行補助 🩼
しんごうたて	しんごうたて 🚦
住宅街	住宅街 🏘️
はんぐぐらいだー	はんぐぐらいだー 🪂
しゃざい	しゃざい 🙇
かーりんぐ	かーりんぐ 🥌
逆再生ボタン	逆再生ボタン ◀️
ほうしゃせい	ほうしゃせい ☢️
平安	平安 🧘
日本	日本 🇯🇵 🎋 🎌 🎍 🎎 🏯 🗾
9じはん	9じはん 🕤️
自由の女神	自由の女神 🗽
デンマーク	デンマーク 🇩🇰
りべりあ	りべりあ 🇱🇷
トウシューズ	トウシューズ 🩰
すいしょうだま	すいしょうだま 🔮
ばんぶつ	ばんぶつ ♾️
かんむり	かんむり 👑 👸
じんこうえいせい	じんこうえいせい 🛰️
開く	開く 📂
サーフィンする人	サーフィンする人 🏄️
グラスで乾杯	グラスで乾杯 🥂
ちょうおんきごう	ちょうおんきごう 〰️
アイスクリーム	アイスクリーム 🍨
蛇遣座	蛇遣座 ⛎️
ラジオ	ラジオ 📻️
むっとしているおとこ	むっとしているおとこ 🙍‍♂️
ハッピー	ハッピー ☺️ 😀 😁 😃 😄 😇 🙂
しるばー	しるばー 🥈
マニキュア	マニキュア 💅
むげん	むげん ♾️
山を登る女	山を登る女 🧗‍♀️
ａｂｃｄ	ａｂｃｄ 🔡
ひとしい	ひとしい 🟰
お酒（とっくり・おちょこ）	お酒（とっくり・おちょこ） 🍶
ブロック	ブロック 🧱
つまんでいる指	つまんでいる指 🤏
ほうしゃせん	ほうしゃせん ☢️
もちかえり	もちかえり 🥡
半月	半月 🌓 🌗 🌛 🌜️
とまれのひょうしき	とまれのひょうしき 🛑
ほっけー	ほっけー 🏑 🏒
立つ女	立つ女 🧍‍♀️
もんてねぐろ	もんてねぐろ 🇲🇪
水球をする男	水球をする男 🤽‍♂️
ごるふをするひと	ごるふをするひと 🏌️
ラベル	ラベル 🏷️
こうさしたはた	こうさしたはた 🎌
タマネギ	タマネギ 🧅
べー	べー 👅 👅 😛 😛 😜 😜 😝 😝 🤑 🤑
ぷらぐ	ぷらぐ 🔌
ドミニカ共和国	ドミニカ共和国 🇩🇴
消防士	消防士 👨‍🚒 👩‍🚒 🧑‍🚒
ちゃわん	ちゃわん 🍚 🍵
にわつきのいえ	にわつきのいえ 🏡
きらきらはーと	きらきらはーと 💖
ぷらす	ぷらす ➕️
ふざけた顔	ふざけた顔 🤪
可マーク	可マーク 🉑
月１	月１ 🌙
じょせいのようせつこう	じょせいのようせつこう 👩‍🏭
ろめんでんしゃしょうめん	ろめんでんしゃしょうめん 🚊
カーリング	カーリング 🥌
スローする	スローする 🤾 🤾‍♀️
じぇっとき	じぇっとき ✈️
デニム	デニム 👖
すとろー	すとろー 🧃
回転するハート	回転するハート 💞
じょがい	じょがい 🙅
居酒屋（赤ちょうちん）	居酒屋（赤ちょうちん） 🏮
ベスト	ベスト 🦺
日めくりカレンダー	日めくりカレンダー 📆
ばるばどす	ばるばどす 🇧🇧
よーろっぱ	よーろっぱ 🌍️
こんらん	こんらん 😕 😖
スカーフ	スカーフ 🧕 🧣
ぶんぼうぐ	ぶんぼうぐ ✂️ ✏️ ✒️ 📁 📂 📇 📋️ 📌 📍 📎 📏 📐 📑 📒 📓 📔 📕 📖 📗 📘 📙 📚️ 📜 📝 🖇️ 🖊️ 🖋️ 🖌️ 🖍️ 🗂️ 🗃️ 🗒️
新しい	新しい 🆕
アジア	アジア 🌏️
かれんだー	かれんだー 📅 📆 🗓️
ブックマーク	ブックマーク 🔖
ヒョウ	ヒョウ 🐆
大きな目	大きな目 🥺
ハリネズミ	ハリネズミ 🦔
あごひげの女性	あごひげの女性 🧔‍♀️
ぱーてぃーのかお	ぱーてぃーのかお 🥳
さきそふぉん	さきそふぉん 🎷
いわい	いわい ㊗️
かつどうてき	かつどうてき 🤸
しのび	しのび 🥷
みにでぃすく	みにでぃすく 💽
反時計回り	反時計回り 🔄
じょぎんぐ	じょぎんぐ 🏃 🏃‍♀️ 🏃‍♀️‍➡️ 🏃‍♂️ 🏃‍♂️‍➡️ 🏃‍➡️
つらら	つらら 🥶 🥶
すぴーかーおんりょうしょう	すぴーかーおんりょうしょう 🔉
べねずえら	べねずえら 🇻🇪
指をクロス	指をクロス 🤞 🫰
マティーニ	マティーニ 🍸️
こうさてん	こうさてん 🚥 🚦
こぼす	こぼす 🫗 🫗
ぴえろのかお	ぴえろのかお 🤡
あずき	あずき 🫘
ふるーとそうしゃ	ふるーとそうしゃ 🪈
とらんすじぇんだー	とらんすじぇんだー 🌈 🏳️‍⚧️ 🏳️‍🌈
懇願	懇願 🥹 🥺
もろっこ	もろっこ 🇲🇦
角の指サイン	角の指サイン 🤘
いのり	いのり 🙏 🛐 🤲
いのる	いのる 📿
じょせいかしゅ	じょせいかしゅ 👩‍🎤
マニキュアを塗る手	マニキュアを塗る手 💅
びじねすまん	びじねすまん 👨‍💼 🕴️
お茶	お茶 🍵 🧉 🧋 🫖
めがはーとのえがお	めがはーとのえがお 😍
ぶい	ぶい 🛟
ゆうびんぽすと	ゆうびんぽすと 📮
だめのぽーずをするおんな	だめのぽーずをするおんな 🙅‍♀️
まいそう	まいそう ⚰️ ⚱️ 🪦
好き	好き 🩵 🩶 🩷
ぶき	ぶき ⚔️ 🏹 🔫 🗡️ 🪃
すてごま	すてごま ♟️
震えている	震えている 🫨
にゅうせいひん	にゅうせいひん 🧈
目が回る	目が回る 💫 😵‍💫
トランスジェンダーのマーク	トランスジェンダーのマーク ⚧️
おまもり	おまもり 🧿 🪬
はきけをもよおしているかお	はきけをもよおしているかお 🤢
じゃんぱい	じゃんぱい 🀄️
大文字	大文字 🔠
にこ（ネコ）	にこ（ネコ） 😺
もやい	もやい 🗿
back	back 🔙
ぶた	ぶた 🐖 🐷 🐷 🐽
優勝	優勝 🏅 🏆️ 🥇
キャラクター（しょんぼり）	キャラクター（しょんぼり） 🙍
ボルト＆ナット	ボルト＆ナット 🔩
上三角１	上三角１ 🔼
上三角２	上三角２ ⏫️
上三角３	上三角３ 🔺
カメラ	カメラ 🎥 🎦 📷️ 📸 📹️ 🤳
根菜	根菜 🫜
ぷらいど	ぷらいど 🏳️‍🌈
怒った悪魔	怒った悪魔 👿
時計	時計 ⌚️ ⌛️ ⏰️ ⏱️ ⏲️ ⏳️ 🕐️ 🕑️ 🕒️ 🕓️ 🕔️ 🕕️ 🕖️ 🕗️ 🕘️ 🕙️ 🕚️ 🕛️ 🕜️ 🕝️ 🕞️ 🕟️ 🕠️ 🕡️ 🕢️ 🕣️ 🕤️ 🕥️ 🕦️ 🕧️ 🕰️
聖地	聖地 🕋
とうきょうたわー	とうきょうたわー 🗼
つぎのきょくぼたん	つぎのきょくぼたん ⏭️
ふるーつ	ふるーつ 🍋‍🟩 🥭
すぺしゃる	すぺしゃる 🩷
スパークル	スパークル ❇️
白いハート	白いハート 💟 🤍
草の者	草の者 🥷
はっかくせい	はっかくせい ✴️
ふるーと	ふるーと 🪈
リマインダーリボン	リマインダーリボン 🎗️
女性の悪役	女性の悪役 🦹‍♀️
むぎわら	むぎわら 👒
はんにん	はんにん 🦹 🦹‍♀️ 🦹‍♂️
ゲームのコントローラ	ゲームのコントローラ 🎮️
正面向きのひよこ	正面向きのひよこ 🐥
おしぴん	おしぴん 📌 📍
てあて	てあて 🩹
タンブラーグラス	タンブラーグラス 🥃
フリスビー	フリスビー 🥏
ろーず	ろーず 🌹
フライ	フライ 🍤
緑茶	緑茶 🍵
へあさろん	へあさろん 💈
ゆうがた	ゆうがた 🌆 🌇
くちにてをあてたかお	くちにてをあてたかお 🤭
スパゲッティー	スパゲッティー 🍝
はちみつ	はちみつ 🍯 🍯
モノクルを付けた顔	モノクルを付けた顔 🧐
ポップコーン	ポップコーン 🍿
らんなー	らんなー 🏃 🏃‍♀️ 🏃‍♀️‍➡️ 🏃‍♂️ 🏃‍♂️‍➡️ 🏃‍➡️
けんさく	けんさく 🔍️ 🔎
おきどけい	おきどけい 🕰️
フラグ	フラグ ⛳️ 🎌 🏁 🏳️ 🏳️‍⚧️ 🏳️‍🌈 🏴 🚩
インヤン	インヤン ☯️
あるこーる	あるこーる 🍷 🍸️ 🍹 🍺 🍻
すろべにあ	すろべにあ 🇸🇮
カスタード	カスタード 🍮
チーズ	チーズ 🍕 🧀 🪤 🫕
しょくぱん	しょくぱん 🍞
工具	工具 ⚒️ ⚙️ ⛏️ 🔧 🔨 🔩 🗜️ 🛠️ 🪓 🪚 🪛
せんとへれな	せんとへれな 🇸🇭
ればのん	ればのん 🇱🇧
あきびん	あきびん 🫙
ろーぷ	ろーぷ 🪢
ラブホ	ラブホ 🏩
魔除け	魔除け 🧿
みみのふじゆうなじょせい	みみのふじゆうなじょせい 🧏‍♀️
しゃっふる	しゃっふる 🔀
ヴぁーさす	ヴぁーさす 🆚
シリア	シリア 🇸🇾
漕ぐ	漕ぐ 🚣
昇降機	昇降機 🛗
注射器	注射器 💉
ハートマーク	ハートマーク ❤️
ねむっているかお	ねむっているかお 😪
せきぞう	せきぞう 🗿
こあら	こあら 🐨
アイススケート	アイススケート ⛸️
正方形	正方形 ▪️ ▫️ ◻️ ◼️ ◽️ ◾️ ⬛️ ⬜️ 🔲 🔳 🟥 🟦 🟧 🟨 🟩 🟪 🟫
じゃまいか	じゃまいか 🇯🇲
バスケットボール	バスケットボール ⛹️ ⛹️‍♀️ ⛹️‍♂️ 🏀
しんにゅうきんし	しんにゅうきんし ⛔️
もうしこみ	もうしこみ 🈸
ドキドキするハート	ドキドキするハート 💓
CD/DVD	CD/DVD 💿️
とらんぷ	とらんぷ ♠️ ♣️ ♥️ ♦️ 🃏
アーティスト	アーティスト 👨‍🎤 👨‍🎨 👩‍🎤 👩‍🎨 🧑‍🎤 🧑‍🎨
すーつ	すーつ 🕴️
女性消防士	女性消防士 👩‍🚒
熱帯	熱帯 🌴 🦩
とろふぃー	とろふぃー 🏆️
5時30分	5時30分 🕠️
まじょ	まじょ 🧙 🧙‍♀️ 🧹
むしぶろ	むしぶろ 🧖
れーざー	れーざー 🪒
すーん	すーん 🔜
右向き三角１	右向き三角１ ▶️
がくふ	がくふ 🎼
右向き三角２	右向き三角２ ⏩️
ウェブ	ウェブ 🕸️
キプロス	キプロス 🇨🇾
じょーい	じょーい 🦘
すーぷ	すーぷ 🍜 🍲
材木	材木 🪵
ゆうじょう	ゆうじょう 👭 🫂
まじん	まじん 🧞 🧞‍♀️ 🧞‍♂️
運動	運動 🏋️
ねこのかsお	ねこのかsお 🐱
はやもどし	はやもどし ⏪️
ー（長音記号１）	ー（長音記号１） 〰️
リップ	リップ 💄
おとこのようせい	おとこのようせい 🧚‍♂️
ごるふ	ごるふ ⛳️ 🏌️ 🏌️‍♀️ 🏌️‍♂️ 🚩
髪をかき上げる	髪をかき上げる 💁
シロクマ	シロクマ 🐻‍❄️
じょーく	じょーく 😜 🤪
サーフィンする女	サーフィンする女 🏄‍♀️
大人二人	大人二人 🧑‍🧑‍🧒 🧑‍🧑‍🧒‍🧒
文書	文書 📃 📄 📜
じゆうがた	じゆうがた 🏊️
みぶんしょうめいしょ	みぶんしょうめいしょ 🪪
プランジャー	プランジャー 🪠
レザー	レザー 🪒
手紙なし	手紙なし 📪️ 📭️
矢印（左斜め上）	矢印（左斜め上） ↖️
マスクメロン	マスクメロン 🍈
うーる	うーる 🐑 🦙
あたたかいのみもの	あたたかいのみもの ☕️
こんびにえんすすとあ	こんびにえんすすとあ 🏪
ワニ	ワニ 🐊
ミクロネシア連邦	ミクロネシア連邦 🇫🇲
ドラゴン	ドラゴン 🐉 🐲
うーん	うーん 🙄 🙄 🤔 🤔
すてっぱー	すてっぱー 🪜
パプアニューギニア	パプアニューギニア 🇵🇬
男性	男性 ♂️ ⛹️‍♂️ 🏃‍♂️ 🏃‍♂️‍➡️ 🏄‍♂️ 🏊‍♂️ 🏋️‍♂️ 🏌️‍♂️ 👨 👨‍⚕️ 👨‍⚖️ 👨‍✈️ 👨‍❤️‍👨 👨‍❤️‍💋‍👨 👨‍🌾 👨‍🍳 👨‍🍼 👨‍🎓 👨‍🎤 👨‍🎨 👨‍🏫 👨‍🏭 👨‍👦 👨‍👦‍👦 👨‍👧 👨‍👧‍👦 👨‍👧‍👧 👨‍👨‍👦 👨‍👨‍👦‍👦 👨‍👨‍👧 👨‍👨‍👧‍👦 👨‍👨‍👧‍👧 👨‍👩‍👦 👨‍👩‍👦‍👦 👨‍👩‍👧 👨‍👩‍👧‍👦 👨‍👩‍👧‍👧 👨‍💻 👨‍💼 👨‍🔧 👨‍🔬 👨‍🚀 👨‍🚒 👨‍🦯 👨‍🦯‍➡️ 👨‍🦰 👨‍🦱 👨‍🦲 👨‍🦳 👨‍🦼 👨‍🦼‍➡️ 👨‍🦽 👨‍🦽‍➡️ 👩‍❤️‍👨 👩‍❤️‍💋‍👨 👫 👬 👮‍♂️ 👯‍♂️ 👰‍♂️ 👱‍♂️ 👲 👳‍♂️ 👴 👷‍♂️ 💁‍♂️ 💂‍♂️ 💆‍♂️ 💇‍♂️ 🕴️ 🕵️ 🕵️‍♂️ 🕺 🙅‍♂️ 🙆‍♂️ 🙇‍♂️ 🙋‍♂️ 🙍‍♂️ 🙎‍♂️ 🚣‍♂️ 🚴‍♂️ 🚵‍♂️ 🚶‍♂️ 🚶‍♂️‍➡️ 🚹️ 🤦‍♂️ 🤴 🤵‍♂️ 🤷‍♂️ 🤸‍♂️ 🤹‍♂️ 🤼‍♂️ 🤽‍♂️ 🤾‍♂️ 🦸‍♂️ 🦹‍♂️ 🧍‍♂️ 🧎‍♂️ 🧎‍♂️‍➡️ 🧏‍♂️ 🧖‍♂️ 🧗‍♂️ 🧘‍♂️ 🧙‍♂️ 🧚‍♂️ 🧛‍♂️ 🧜‍♂️ 🧝‍♂️ 🧞‍♂️ 🧟‍♂️ 🫃
てんしん	てんしん 🥟
しろいぎもんふ	しろいぎもんふ ❔️
ワシ	ワシ 🦅
ふらいどぽてと	ふらいどぽてと 🍟
パンダの顔	パンダの顔 🐼
どいつ	どいつ 🇩🇪
肉球	肉球 🐾
考える	考える 🤔 🧐
おひなさま	おひなさま 🎎
いれこ	いれこ 🪆
義足	義足 🦿
祝マーク	祝マーク ㊗️
らくろす	らくろす 🥍
あしか	あしか 🦭
ゴルファー	ゴルファー 🏌️ 🏌️‍♀️ 🏌️‍♂️
歩行者	歩行者 🚶 🚶‍♀️ 🚶‍♀️‍➡️ 🚶‍♂️ 🚶‍♂️‍➡️ 🚶‍➡️
しるえっと	しるえっと 👤 👥 🗣️
きょだい	きょだい 🦣
転法輪	転法輪 ☸️
電源オフ	電源オフ 📴
側転する男	側転する男 🤸‍♂️
墓地	墓地 🪦
うまい！	うまい！ 😋
アイスランド	アイスランド 🇮🇸
止まれ	止まれ 🛑 🫷 🫸
ひやしんす	ひやしんす 🪻
グリーンランド	グリーンランド 🇬🇱
トリスタン・ダ・クーニャ	トリスタン・ダ・クーニャ 🇹🇦
ねんじゅ	ねんじゅ 📿
きっくぼーど	きっくぼーど 🛴
循環矢印	循環矢印 ♻️
学生	学生 👨‍🎓 👩‍🎓 🧑‍🎓
だびで	だびで 🔯
学校、幼稚園、保育所等あり	学校、幼稚園、保育所等あり 🚸
まきもの	まきもの 📜
ひがさ	ひがさ ⛱️
ひがし	ひがし ➡️
救助	救助 🛟
人間	人間 👱
次のトラック	次のトラック ⏭️
おんど	おんど 🌡️
おんな	おんな ♀️ 🏄‍♀️ 🏊‍♀️ 🏋️‍♀️ 🏌️‍♀️ 👧 👩 👩‍⚕️ 👩‍⚖️ 👩‍✈️ 👩‍🌾 👩‍🍳 👩‍🍼 👩‍🎓 👩‍🎤 👩‍🎨 👩‍🏫 👩‍🏭 👩‍💻 👩‍💼 👩‍🔧 👩‍🔬 👩‍🚀 👩‍🚒 👩‍🦰 👩‍🦱 👩‍🦲 👩‍🦳 👫 👭 👯‍♀️ 👰‍♀️ 👱‍♀️ 👳‍♀️ 👷‍♀️ 👸 💁‍♀️ 💃 💆‍♀️ 🕵️‍♀️ 🙅‍♀️ 🙇‍♀️ 🙋‍♀️ 🙍‍♀️ 🙎‍♀️ 🚣‍♀️ 🚴‍♀️ 🚵‍♀️ 🤦‍♀️ 🤰 🤱 🤵‍♀️ 🤶 🤷‍♀️ 🤹‍♀️ 🧔‍♀️ 🧕 🧖‍♀️ 🧗‍♀️ 🧘‍♀️ 🧙‍♀️ 🧚‍♀️ 🧛‍♀️ 🧜‍♀️ 🧝‍♀️ 🧞‍♀️ 🧟‍♀️
しりつたんてい	しりつたんてい 🕵️ 🕵️‍♀️
ふろっぴーでぃすく	ふろっぴーでぃすく 💾
切り株	切り株 🪵
こしかけ	こしかけ 🪑
しゃりょうつうこうどめ	しゃりょうつうこうどめ 🚫
しましま	しましま 🦓 🦓
クリップ	クリップ 📋️ 📎 🖇️
すいしょう	すいしょう 🔮
成人女性	成人女性 👩
じてんしゃ	じてんしゃ 🚲️ 🚳 🚴 🚴‍♀️ 🚵 🚵‍♀️ 🚵‍♂️
えいぎょうちゅう	えいぎょうちゅう 🈺
やまたかぼう	やまたかぼう 🎩
おんぷ	おんぷ 🎵 🎶
かたい	かたい 🪨
ふぁいる	ふぁいる 📁 📂 🗃️ 🗄️
ロールプレイ	ロールプレイ 🧙
びる	びる 🌆 🌇 🏢 🏬
くろしかくしょう	くろしかくしょう ▪️
ハートブレイク	ハートブレイク 💔
化学者	化学者 🧑‍🔬 🧪
びん	びん 🫙 🫙
みずやり	みずやり 🪴
ちゅうい	ちゅうい ⚠️
トレイ	トレイ 📤️ 📥️
VHS	VHS 📼 📼
表情（冷や汗）	表情（冷や汗） 😓
手の甲上指差し	手の甲上指差し 👆️
そうしんばこ	そうしんばこ 📤️
ファイルキャビネット	ファイルキャビネット 🗄️
ちゅうか	ちゅうか 🥡
むらさきいろ	むらさきいろ 🪻
ためいき	ためいき 😮‍💨
がっこう	がっこう 🎒 🏫 📔 📚️
ノート１	ノート１ 📓
バンパイア	バンパイア 🦇 🧛 🧛‍♀️ 🧛‍♂️
ノート３	ノート３ 📔
下カーブ矢印	下カーブ矢印 ⤵️
マダガスカル	マダガスカル 🇲🇬
肉食動物	肉食動物 🐅 🐆
ふきつ	ふきつ 🐈‍⬛
ふたこぶらくだ	ふたこぶらくだ 🐫 🐫
かため	かため 👁️
ウォーキング	ウォーキング 🚶 🚶‍♀️ 🚶‍♀️‍➡️ 🚶‍♂️ 🚶‍♂️‍➡️ 🚶‍➡️
怒り	怒り 👺 💢 🗯️ 😠 😡 😤 🤬
閉じた本	閉じた本 📕
かたな	かたな ⚔️
財布	財布 👛
メール受信（郵便受け）	メール受信（郵便受け） 📫️
大好き	大好き 😍
くりっぷぼーど	くりっぷぼーど 📋️
にっこりわらう	にっこりわらう 😀
スイカ	スイカ 🍉
ろーふぁー	ろーふぁー 👞
スケート	スケート ⛸️ 🛼
悔しい	悔しい 🫦
くしゃみ	くしゃみ 😫 😫 🤧 🤧
えーがた	えーがた 🅰️
おくとぱす	おくとぱす 🐙
スイス	スイス 🇨🇭 🫕
だんせいぎじゅつしゃ	だんせいぎじゅつしゃ 👨‍💻
せいじょう	せいじょう 🪷
じょせいのあくやく	じょせいのあくやく 🦹‍♀️
左右両方向矢印	左右両方向矢印 ↔️
英小文字の入力	英小文字の入力 🔡
表情（ふらふら）	表情（ふらふら） 😲
開いた両手	開いた両手 👐
スイム	スイム 🏊️ 🏊‍♀️ 🏊‍♂️
まさか	まさか 😲 😲
ファクトリー	ファクトリー 🏭️
寝る	寝る 💤 😪 😴 🛌 🛏️
りぴーと	りぴーと 🔁 🔂 🔄
だんせい	だんせい ♂️ ⛹️‍♂️ 🏃‍♂️ 🏃‍♂️‍➡️ 🏄‍♂️ 🏊‍♂️ 🏋️‍♂️ 🏌️‍♂️ 👨 👨‍⚕️ 👨‍⚖️ 👨‍✈️ 👨‍❤️‍👨 👨‍❤️‍💋‍👨 👨‍🌾 👨‍🍳 👨‍🍼 👨‍🎓 👨‍🎤 👨‍🎨 👨‍🏫 👨‍🏭 👨‍👦 👨‍👦‍👦 👨‍👧 👨‍👧‍👦 👨‍👧‍👧 👨‍👨‍👦 👨‍👨‍👦‍👦 👨‍👨‍👧 👨‍👨‍👧‍👦 👨‍👨‍👧‍👧 👨‍👩‍👦 👨‍👩‍👦‍👦 👨‍👩‍👧 👨‍👩‍👧‍👦 👨‍👩‍👧‍👧 👨‍💻 👨‍💼 👨‍🔧 👨‍🔬 👨‍🚀 👨‍🚒 👨‍🦯 👨‍🦯‍➡️ 👨‍🦰 👨‍🦱 👨‍🦲 👨‍🦳 👨‍🦼 👨‍🦼‍➡️ 👨‍🦽 👨‍🦽‍➡️ 👩‍❤️‍👨 👩‍❤️‍💋‍👨 👫 👬 👮‍♂️ 👯‍♂️ 👰‍♂️ 👱‍♂️ 👲 👳‍♂️ 👴 👷‍♂️ 💁‍♂️ 💂‍♂️ 💆‍♂️ 💇‍♂️ 🕴️ 🕵️ 🕵️‍♂️ 🕺 🙅‍♂️ 🙆‍♂️ 🙇‍♂️ 🙋‍♂️ 🙍‍♂️ 🙎‍♂️ 🚣‍♂️ 🚴‍♂️ 🚵‍♂️ 🚶‍♂️ 🚶‍♂️‍➡️ 🚹️ 🤦‍♂️ 🤴 🤵‍♂️ 🤷‍♂️ 🤸‍♂️ 🤹‍♂️ 🤼‍♂️ 🤽‍♂️ 🤾‍♂️ 🦸‍♂️ 🦹‍♂️ 🧍‍♂️ 🧎‍♂️ 🧎‍♂️‍➡️ 🧏‍♂️ 🧖‍♂️ 🧗‍♂️ 🧘‍♂️ 🧙‍♂️ 🧚‍♂️ 🧛‍♂️ 🧜‍♂️ 🧝‍♂️ 🧞‍♂️ 🧟‍♂️ 🫃
聞かざる	聞かざる 🙉
更新（ＵＰ！）	更新（ＵＰ！） 🆙
ぷりんたー	ぷりんたー 🖨️
大股	大股 🚶 🚶‍➡️
ポテト	ポテト 🍟 🥔
フラッグ	フラッグ ⛳️ 🎌 🏁 🏳️ 🏳️‍⚧️ 🏴 🚩
墓場	墓場 🪦
みずがめ座	みずがめ座 ♒️
補助	補助 🐕‍🦺 🦮
扇子	扇子 🪭
バニーボーイ	バニーボーイ 👯‍♂️
満員	満員 🈵
薄笑いをする顔	薄笑いをする顔 😏
うんどう	うんどう 🏋️
まえのしーん	まえのしーん ⏮️
折れ線グラフ	折れ線グラフ 📈 📉
すうじ	すうじ 🔢
チャック	チャック 🤐
でぃすかうんと	でぃすかうんと 🈹
でんちざんりょうていか	でんちざんりょうていか 🪫
しらが	しらが 👨‍🦳 👩‍🦳 🦳 🧑‍🦳
ほうこう	ほうこう 🫱 🫲
Ａ型	Ａ型 🅰️
運命	運命 🔮
したをだしたかお	したをだしたかお 😛 🥵
すぴーどぼーと	すぴーどぼーと 🚤
しらけ	しらけ 😒 😒
知識	知識 📖 🧠
てんごく	てんごく 🪽
ロープ	ロープ 🪢
COOLマーク	COOLマーク 🆒
男女	男女 👫
ころんびあ	ころんびあ 🇨🇴
てをあげるじん	てをあげるじん 🙋
びーつ｜にわ｜ね｜かぶ｜やさい	びーつ｜にわ｜ね｜かぶ｜やさい 🫜
ローズ	ローズ 🌹
同性	同性 👬 👭
保存	保存 🫙
さかさまのかお	さかさまのかお 🙃
合衆国領有小離島	合衆国領有小離島 🇺🇲
七夕笹飾り	七夕笹飾り 🎋
じょうき	じょうき 🧖
くんしょう	くんしょう 🎖️
じょうぎ	じょうぎ 📏 📐
みぎした	みぎした ↘️
無料（ＦＲＥＥ）	無料（ＦＲＥＥ） 🆓
じょうげ	じょうげ ↕️ 🪀
はちぇっと	はちぇっと 🪓
0系	0系 🚅
きつえん	きつえん 🚬
ぺっと	ぺっと 🐇 🐈️ 🐕️ 🐩 🐰 🐱 🐶 🐹
スーツ	スーツ 🕴️
矢印（左）	矢印（左） ⬅️
がまぐちざいふ	がまぐちざいふ 👛
てにもつ	てにもつ 🛄 🛅
オマーン	オマーン 🇴🇲
やきゅう	やきゅう ⚾️
いらく	いらく 🇮🇶
しぶき｜ペンキ｜飛沫｜飛び散り｜スプラッシュ	しぶき｜ペンキ｜飛沫｜飛び散り｜スプラッシュ 🫟
西サハラ	西サハラ 🇪🇭
夕方	夕方 🌆 🌇
ううん	ううん 🙂‍↔️ 🙂‍↔️
ショウガ	ショウガ 🫚
スープ	スープ 🍜 🍲
こぶし	こぶし ✊️ ✊️ 👊 👊 🤛 🤛 🤜 🤜
ページ	ページ 📄
じょうば	じょうば 🏇 🐎
除算	除算 ➗️
ほくせい	ほくせい ↖️
〒♪&%	〒♪&% 🔣 🔣
夕日	夕日 🌆 🌇
りょうしゅうしょ	りょうしゅうしょ 🧾
びでおげーむ	びでおげーむ 🎮️ 🕹️
サイエンス	サイエンス 🔬 🔭
てんとうむし	てんとうむし 🐞
おうかん	おうかん 👑
おはか	おはか 🪦
毛糸玉	毛糸玉 🧶
にっこり笑う	にっこり笑う 😀
足あと	足あと 👣
ラップサンド	ラップサンド 🌯 🥙
いらん	いらん 🇮🇷
クック諸島	クック諸島 🇨🇰
ビキニ	ビキニ 👙
デート	デート 💑 💕 😗 😚
まりょく	まりょく 🧝
よがのぽーずをするおんな	よがのぽーずをするおんな 🧘‍♀️
おはし	おはし 🥢 🥢
ターバンの男性	ターバンの男性 👳‍♂️
しかくぼたん	しかくぼたん 🔲 🔳
下矢印	下矢印 ⬇️
ふくれっつら	ふくれっつら 😡
時間	時間 ⌚️ ⏰️ ⏳️ 🕰️
キャンプ	キャンプ ⛺️ 🏕️ 🥾
お銚子＆杯	お銚子＆杯 🍶
ぺんぎん	ぺんぎん 🐧
ぐりーんさらだ	ぐりーんさらだ 🥗
キャッシュカード	キャッシュカード 💳️
質問	質問 🙋
てをつなぐ	てをつなぐ 🧑‍🤝‍🧑
ボートをこぐ男	ボートをこぐ男 🚣‍♂️
ぶっきょう	ぶっきょう ☸️ 🪷
重量挙げ	重量挙げ 🏋️
ひーる	ひーる 👠
ばす	ばす 🚌 🚍️ 🚎 🚐
はちぶおんぷ	はちぶおんぷ 🎵 🎶
データ	データ 📈 📉 📊
サツマイモ	サツマイモ 🍠
トラの顔	トラの顔 🐯
ひゃくてんまんてん	ひゃくてんまんてん 💯
航空機	航空機 ✈️ 🛩️ 🛫 🛬
ばれえ	ばれえ 🩰
蟹座	蟹座 ♋️
腰掛け	腰掛け 🪑
ばつ	ばつ ✖️ ❌️ ❎️ 🙅 🙅‍♀️ 🙅‍♂️
銀行	銀行 🏦 🏧 💰️ 💳️
ウール	ウール 🐑 🦙
えびてん	えびてん 🍤
ばら	ばら 🌹
らんにんぐしゃつ	らんにんぐしゃつ 🎽
すとっく	すとっく ⛷️ 🎿
白杖をついた女性	白杖をついた女性 👩‍🦯 👩‍🦯‍➡️
ばね	ばね 🪤 🪤
フォルダ２（開）	フォルダ２（開） 📂
はっしゃ	はっしゃ 🚀
むーす	むーす 🫎
ばば	ばば 🃏
工員	工員 👨‍🏭 👩‍🏭 🧑‍🏭
夕方の街	夕方の街 🌆
日没	日没 🌇
仏領ポリネシア	仏領ポリネシア 🇵🇫
めーるする	めーるする 📩
でんでん虫	でんでん虫 🐌
表情（考え中）	表情（考え中） 😔
サンダル	サンダル 👡 🩴
野牛	野牛 🦬
右上矢印	右上矢印 ↗️
のぞき見	のぞき見 🫣
ホラー	ホラー 🧟 🧟‍♀️ 🧟‍♂️
あらぶしゅちょうこくれんぽう	あらぶしゅちょうこくれんぽう 🇦🇪
おいわい	おいわい ㊗️ 🎀 🎁 🎂 🎉 🎊 🎍 🎎 🎏 🎖️ 🎗️ 🥮 🥳 🪅
なみのり	なみのり 🏄️ 🏄‍♀️ 🏄‍♂️
女性の探偵	女性の探偵 🕵️‍♀️
ぶんぐ	ぶんぐ ✂️ ✏️ ✒️ 📁 📂 📇 📋️ 📌 📍 📎 📏 📐 📑 📒 📓 📔 📝 🖇️ 🖊️ 🖋️ 🖌️ 🖍️ 🗂️ 🗃️ 🗒️
通行止め	通行止め 🚧 🚫
ひやけどめ	ひやけどめ 🧴
ラクダ	ラクダ 🐪 🐫
たなばた	たなばた 🎋
赤色灯	赤色灯 🚨
しろいまる	しろいまる ⚪️
ふらんすおうけ	ふらんすおうけ ⚜️
ぶんし	ぶんし ⚛️
しつもん	しつもん 🙋
ゆううつ	ゆううつ 🫥
ぎそく	ぎそく 🦿
すとっぷ	すとっぷ ⏹️ ✋️ 🖐️ 🛑 🫷 🫸
BACK	BACK 🔙
勝ち誇った顔	勝ち誇った顔 😤
げいじゅつ	げいじゅつ 🎨 🎭️ 🖼️
怒った顔	怒った顔 😠
配管工	配管工 👨‍🔧 👩‍🔧
表情（やれやれ）	表情（やれやれ） 😥
点心	点心 🥟
バレーボール	バレーボール 🏐
たんぶらーぐらす	たんぶらーぐらす 🥃
あこーでぃおん	あこーでぃおん 🪗
学者	学者 🎓️
ふらみんご	ふらみんご 🦩
ラバシ	ラバシ 🫓
みぎかたさがり	みぎかたさがり 📉
かんでんち	かんでんち 🔋
あかいぎもんふ	あかいぎもんふ ❓️
よつば	よつば 🍀
ぽっぷこーん	ぽっぷこーん 🍿
はいおく	はいおく 🏚️
灰色	灰色 🩶
とけい	とけい ⌚️ ⌛️ ⏰️ ⏱️ ⏲️ ⏳️ 🕐️ 🕑️ 🕒️ 🕓️ 🕔️ 🕕️ 🕖️ 🕗️ 🕘️ 🕙️ 🕚️ 🕛️ 🕜️ 🕝️ 🕞️ 🕟️ 🕠️ 🕡️ 🕢️ 🕣️ 🕤️ 🕥️ 🕦️ 🕧️ 🕰️
がーな	がーな 🇬🇭
もーりしゃす	もーりしゃす 🇲🇺
蒸しぶろ	蒸しぶろ 🧖
くろはーと	くろはーと ❤️
書類	書類 📃 📄 📜
黒丸	黒丸 ⚫️
月めくりカレンダー	月めくりカレンダー 🗓️
がーん	がーん 😨 😨 😱 😱 🙀 🙀 🫨
郊外	郊外 🏠️ 🏡
棒グラフ	棒グラフ 📊
ばー	ばー 🍷 🍸️ 🍹 🍺 🍻 🍾
らばーかっぷ	らばーかっぷ 🪠
便座	便座 🚽
ばすのりば	ばすのりば 🚏
ジェスチャー（オッケー）	ジェスチャー（オッケー） 🙆
はいち	はいち 🇭🇹
めざましどけい	めざましどけい ⏰️
ラトビア	ラトビア 🇱🇻
パラセーリング	パラセーリング 🪂
禁止された	禁止された 🙅
ぴこーん	ぴこーん 💡 💡
水族館	水族館 🪼
ピーコック	ピーコック 🦚
SOON矢印	SOON矢印 🔜
トボガン	トボガン 🛷
フレーム	フレーム 🎞️ 🪟
みぎかたあがり	みぎかたあがり 📈
だんじょ	だんじょ 👫
ばれー	ばれー 🏐
ばにー	ばにー 👯
とらっくぼーる	とらっくぼーる 🖲️
とける	とける 🫠
よーよー	よーよー 🪀
ナッツ	ナッツ 🥜
おてあげ	おてあげ 🤷 🤷‍♀️ 🤷‍♂️
スウェーデン	スウェーデン 🇸🇪
ＡＴＭ	ＡＴＭ 🏧 🏧
スカンク	スカンク 🦨
サクラ	サクラ 🌸
ナット	ナット 🔩
マルタ	マルタ 🇲🇹
だびでのほし	だびでのほし ✡️
しおふきくじら	しおふきくじら 🐳
じゅうさんよつき	じゅうさんよつき 🌔
おおかみのかお	おおかみのかお 🐺
ばんぐらでしゅ	ばんぐらでしゅ 🇧🇩
火の付いた	火の付いた ❤️‍🔥
いこーる	いこーる 🟰
だいおんりょう	だいおんりょう 🔊
らいおん	らいおん 🦁
てぃーぽっと	てぃーぽっと 🫖
にげる	にげる 💨
バルバドス	バルバドス 🇧🇧
ラバ	ラバ 🫏
ろけっと	ろけっと 🚀 🧑‍🚀
カラオケ（マイク）	カラオケ（マイク） 🎤
およぐひと	およぐひと 🏊️
ハンドボールをする男	ハンドボールをする男 🤾‍♂️
ラブ	ラブ 💕 😍 🥰 🩵 🩶 🩷 🫶
Phone	Phone 📲
らいとれーる	らいとれーる 🚈
ぐあどるーぷ	ぐあどるーぷ 🇬🇵
バナナ	バナナ 🍌
ラボ	ラボ 🧪
せんとう	せんとう 🪖
ラマ	ラマ 🦙
仏領極南諸島	仏領極南諸島 🇹🇫
ラム	ラム 🥩
くちをあけたえがお	くちをあけたえがお 😃
さけび	さけび 😱
バングラデシュ	バングラデシュ 🇧🇩
れいんぼー	れいんぼー 🌈 🏳️‍🌈
ぱすた	ぱすた 🍝
べらるーし	べらるーし 🇧🇾
ランニングシャツ	ランニングシャツ 🎽
お姫様	お姫様 👸
ハート２（われている）	ハート２（われている） 💔
好奇心	好奇心 🦝
マナーモード	マナーモード 📳
びようしつ	びようしつ 💇 💇‍♀️ 💇‍♂️ 💈
べびー	べびー 👶 🚼️
おうえん	おうえん 📣
こがたき	こがたき 🛩️
かくだいきょう	かくだいきょう 🔍️ 🔎
こんぴゅーたー	こんぴゅーたー ⌨️ 💻️ 💽 💾 💿️ 🖥️ 🖨️ 🖱️ 🖲️
やきもち	やきもち 😑 😑 😒 😒
けむし	けむし 🐛
きせいちゅう	きせいちゅう 🪱
捨て駒	捨て駒 ♟️
感動	感動 🥲
男性と女性と男の子と男の子の家族	男性と女性と男の子と男の子の家族 👨‍👩‍👦‍👦
ヘアサロン	ヘアサロン 💈
きゃくせん	きゃくせん ⛴️ 🚢 🛳️
たんけん	たんけん 🗡️
中華帽の男性	中華帽の男性 👲
呪文	呪文 🧙
サラリーマン	サラリーマン 👨‍💼 👩‍💼 🧑‍💼
きもちわるい	きもちわるい 🤢 🤮
ふろにはいるじん	ふろにはいるじん 🛀
あける	あける 🪟
軍隊	軍隊 🪖 🫡
捜索（SOS）	捜索（SOS） 🆘
小菱形１	小菱形１ 🔸
ねぎ	ねぎ 🧅 🧅
ドラム缶	ドラム缶 🛢️
小菱形２	小菱形２ 🔹
あおぴーまん	あおぴーまん 🫑
ししゅう	ししゅう 🪡
歌手	歌手 👨‍🎤 👩‍🎤 🧑‍🎤
幸運を	幸運を 🤞
えいせい	えいせい 🪥
ねこ	ねこ 🐈️ 🐈‍⬛ 🐱 🐾 😸 😹 😺 😻 😼 😽 😾 😿 🙀
砂が落ちている砂時計	砂が落ちている砂時計 ⏳️
ほっとした	ほっとした 😮‍💨 😮‍💨
野球	野球 ⚾️
お酒	お酒 🍷 🍸️ 🍹 🍺
じょせいのたんてい	じょせいのたんてい 🕵️‍♀️
ヴィオラ	ヴィオラ 🎻
絵の具	絵の具 🖌️
すべりだい	すべりだい 🛝
猟犬	猟犬 🐶
しゅくじつ	しゅくじつ 🇯🇵 🎌
ペーパータオル	ペーパータオル 🧻
受信箱１	受信箱１ 📫️
線路	線路 🛤️
ほんこん	ほんこん 🇭🇰
ねつ	ねつ 🦟
アメリカ合衆国	アメリカ合衆国 🇺🇸
お手洗い	お手洗い 🚹️ 🚺️ 🚻 🚽 🚾
すべり台	すべり台 🛝
タイム	タイム ⏱️
てちょう	てちょう 📓
ねる	ねる 💤 😪 😴 🛌 🛏️
タイヤ	タイヤ 🛞
メモ帳	メモ帳 🗒️
工事	工事 🏗️ 👷 👷‍♀️ 👷‍♂️ 🦺
びーちさんだる	びーちさんだる 🩴
かんこく	かんこく 🇰🇷
ごうまーく	ごうまーく 🈴
紙幣	紙幣 💴 💵 💶 💷 💸
びーさん	びーさん 🩴
ＤＶＤ	ＤＶＤ 📀
日本の城	日本の城 🏯
こんとろーらー	こんとろーらー 🎮️
ハートデコレーション	ハートデコレーション 💟
送信箱	送信箱 📤️
ぱんぷきんぱい	ぱんぷきんぱい 🥧
しゃおく	しゃおく 🏢
女王	女王 👸 🫅
果実	果実 🫒
スイーツ	スイーツ 🍦 🍧 🍨 🍩 🍪 🍫 🍮 🍰 🎂 🧁
下手投げ	下手投げ 🥎
くれーん	くれーん 🏗️
ばくはつ	ばくはつ 💣️ 💥 🤯 🧨
びるべりー	びるべりー 🫐
でんどうくるまいすのじょせい	でんどうくるまいすのじょせい 👩‍🦼 👩‍🦼‍➡️
パエリア鍋	パエリア鍋 🥘
おーとみーる	おーとみーる 🥣
タキシード	タキシード 🤵 🤵‍♀️ 🤵‍♂️
がんせき	がんせき 🪨
にくまん	にくまん 🥟
くるまいす	くるまいす ♿️ 👨‍🦼 👨‍🦼‍➡️ 👨‍🦽 👨‍🦽‍➡️ 👩‍🦼 👩‍🦼‍➡️ 👩‍🦽 👩‍🦽‍➡️ 🦼 🦽 🧑‍🦼 🧑‍🦼‍➡️ 🧑‍🦽 🧑‍🦽‍➡️
ファラフェル	ファラフェル 🧆
はんざいしゃ	はんざいしゃ 🦹
ぎゃくさいせいぼたん	ぎゃくさいせいぼたん ◀️
白髪	白髪 👨‍🦳 👩‍🦳 🦳 🧑‍🦳
ドリンク	ドリンク 🧃 🧉 🧋
りふと	りふと 🚠 🛗
フロッピーディスク１	フロッピーディスク１ 💾
あごひげの男性	あごひげの男性 🧔‍♂️
はくちょう	はくちょう 🦢
ゆーじがたじしゃく	ゆーじがたじしゃく 🧲
あげたこぶし	あげたこぶし ✊️
ふたご座	ふたご座 ♊️
巻き戻し	巻き戻し ⏪️ ◀️
お金	お金 💰️ 💱 💲 💳️ 💴 💵 💶 💷 💸 🤑 🧧 🪙 🫰
いざかや	いざかや 🍺 🏮
複合機	複合機 📠 🖨️
びでおかせっと	びでおかせっと 📼
ごーるねっと	ごーるねっと 🥅
紫色	紫色 🪻
男性のスーパーヒーロー	男性のスーパーヒーロー 🦸‍♂️
ネイル	ネイル 💅
茶色い四角	茶色い四角 🟫
冷や汗2	冷や汗2 😓
顔１（うれしいカオ）	顔１（うれしいカオ） 😃
きょうぎじょう	きょうぎじょう 🏟️
ひとかげ	ひとかげ 👤
授乳	授乳 👨‍🍼 👩‍🍼 🤱 🧑‍🍼
パーキング	パーキング 🅿️
しゃんぺん	しゃんぺん 🍾 🥂
白抜きのバツ	白抜きのバツ ❎️
ほしとみかづき	ほしとみかづき ☪️
日本地図	日本地図 🗾
しおれた	しおれた 🥀 🥀
ぱとろーる	ぱとろーる 🚓
カナリア諸島	カナリア諸島 🇮🇨
シンガー	シンガー 👨‍🎤 👩‍🎤 🧑‍🎤
ムード	ムード 🎶
おんなのせいれい	おんなのせいれい 🧞‍♀️
モノレール	モノレール 🚈 🚝 🚟
巨大	巨大 🦣
まえのとらっく	まえのとらっく ⏮️
初心者マーク	初心者マーク 🔰
ホンジュラス	ホンジュラス 🇭🇳
えいびーがた	えいびーがた 🆎
ふとじのとうごう	ふとじのとうごう 🟰
すぱげてぃ	すぱげてぃ 🍝
しょうひょうまーく	しょうひょうまーく ™️
みぎかーぶやじるし	みぎかーぶやじるし ↩️
ムース	ムース 🫎
こくもつ	こくもつ 🌾
かみくりっぷ	かみくりっぷ 📎 🖇️
はなまる	はなまる 💮 💮
小銭	小銭 🪙
赤いハート	赤いハート ❤️
じょいすてぃっく	じょいすてぃっく 🕹️
ヒヤシンス	ヒヤシンス 🪻
たきしーどのじょせい	たきしーどのじょせい 🤵‍♀️
陰陽	陰陽 ☯️
ごうきゅうするかお	ごうきゅうするかお 😭
ロードレース	ロードレース 🚴 🚴‍♀️ 🚴‍♂️
あるじぇりあ	あるじぇりあ 🇩🇿
工作	工作 👨‍🔧 👩‍🔧 🧑‍🔧
性別	性別 ⚧️
れきしてきけんぞうぶつ	れきしてきけんぞうぶつ 🏛️
時計（７時）	時計（７時） 🕖️
空き家	空き家 🏚️
ガーナ	ガーナ 🇬🇭
しゃつ	しゃつ 🎽 👔 👕 👚
赤ちゃん	赤ちゃん 🍼 👨‍🍼 👩‍🍼 👶 🚼️ 🤱 🧑‍🍼
びーるでかんぱい	びーるでかんぱい 🍻
ぶいえす	ぶいえす 🆚
ばらんす	ばらんす ⚖️
走る男	走る男 🏃‍♂️ 🏃‍♂️‍➡️
ぱーきんぐ	ぱーきんぐ 🅿️
回転木馬	回転木馬 🎠
小説	小説 📖 📚️
黒電話	黒電話 ☎️
傘と雨	傘と雨 ☔️
ふまん	ふまん 😒 😠 😦 🙍 🫤
気持ち悪い	気持ち悪い 🤢 🤮
きっさてん	きっさてん ☕️
すぴーかー	すぴーかー 📢 📣 🔇 🔈️ 🔉 🔊
流れ星	流れ星 🌃 🌠 💫
溶接工	溶接工 🧑‍🏭
助けて	助けて 🆘
プリンター	プリンター 🖨️
あかいかお	あかいかお 😡 🥵
成長	成長 📈
国旗（日本）	国旗（日本） 🇯🇵
双葉	双葉 🌱
ごうきゅう	ごうきゅう 😭
らぐびーぼーる	らぐびーぼーる 🏈 🏉
むらさき	むらさき 💜 🟣 🟪
やきゅうぼーる	やきゅうぼーる ⚾️
けいやくせいりつ	けいやくせいりつ 🤝
くろねこ	くろねこ 🐈‍⬛
ガーン	ガーン 🫨
きゅうじょたい	きゅうじょたい ⛑️ 🧑‍🚒
ユリ	ユリ ⚜️
工具箱	工具箱 🧰
ろーるぺーぱー	ろーるぺーぱー 🧻
ゆにこーんのかお	ゆにこーんのかお 🦄
ないしょ	ないしょ 🙊 🤐 🤭
救急	救急 ⛑️
びるま	びるま 🇲🇲
じょせいぱいろっと	じょせいぱいろっと 👩‍✈️
えすわてぃに	えすわてぃに 🇸🇿
ヘルメット	ヘルメット ⛑️ 👷 👷‍♀️ 👷‍♂️ 🪖
パンチパーマ	パンチパーマ 🦱
親友	親友 👯 👯‍♂️
だんさー	だんさー 👯 👯‍♀️ 👯‍♂️ 💃 🕺
ゆーろ	ゆーろ 💶
痛い	痛い 🤕
女性歌手	女性歌手 👩‍🎤
なえ	なえ 🪴
嬉し涙の顔	嬉し涙の顔 🥲
カフェ	カフェ ☕️
なか	なか 🀄️
ワンピースの水着	ワンピースの水着 🩱
星座（いて座）	星座（いて座） ♐️
開いた錠	開いた錠 🔓️
はないき	はないき 😤
目を回した顔	目を回した顔 😵‍💫
なく	なく 😢 😭 😿 🥲
きょしゅ	きょしゅ ✋️ 🖐️ 🙋 🙋‍♀️ 🙋‍♂️
工場	工場 🏭️ 🧑‍🏭
しんぼる	しんぼる ♀️ ♂️ ⚧️
そつぎょう	そつぎょう 🎓️ 👨‍🎓 👩‍🎓 🧑‍🎓
とうしゅーず	とうしゅーず 🩰
ちょうおん	ちょうおん ➰️
なし	なし 🍐
散歩	散歩 🚶 🚶‍♀️ 🚶‍♀️‍➡️ 🚶‍➡️
リラックス	リラックス 💆 💆‍♂️ 🧖 🧘
なす	なす 🍆 🍆
ぼんっ	ぼんっ 💥 💥 🤯 🤯
のうかのじょせい	のうかのじょせい 👩‍🌾
ほんのやま	ほんのやま 📚️
ボタン１	ボタン１ 🔴
ボタン２	ボタン２ 🔲
ボタン３	ボタン３ 🔳
げーむ	げーむ 🀄️ 🎮️ 🎰 🎲 🎴 👾 🕹️ 🥌
いわいまーく	いわいまーく ㊗️
ちしき	ちしき 📖 🧠
なつ	なつ 🎐 🪭
ひじょうしょく	ひじょうしょく 🥫
実験	実験 ⚖️ ⚗️ 🔬 🥼 🧪 🧫
スロベニア	スロベニア 🇸🇮
ぼりゅーむ	ぼりゅーむ 🔈️ 🔉 🔊
ずつう	ずつう 😓 😣
しつぼうしたかお	しつぼうしたかお 😞
みぎゆびさし	みぎゆびさし 👉️
医療器具	医療器具 💉
とぅくとぅく	とぅくとぅく 🛺
聴覚	聴覚 🦻 🧏 🧏‍♀️ 🧏‍♂️
らんにんぐ	らんにんぐ 🎽 🏃 🏃‍♀️ 🏃‍♀️‍➡️ 🏃‍♂️ 🏃‍♂️‍➡️ 🏃‍➡️
メールボックス	メールボックス 📪️
敬礼	敬礼 🫡
ぽけべる	ぽけべる 📟️
がそりんのずる	がそりんのずる ⛽️
けっしょう	けっしょう ❄️
なん	なん 🫓
りんく	りんく 🔗
りんぐ	りんぐ 💍 🪐
4じはん	4じはん 🕟️
ごせんふ	ごせんふ 🎼
りんご	りんご 🍎 🍎 🍏 🍏
ハヌカー	ハヌカー 🕎
弓矢	弓矢 🏹
シャッフル	シャッフル 🔀
なべ	なべ 🍲 🍲 🫕
人魚	人魚 🧜 🧜‍♀️ 🧜‍♂️
まんとう	まんとう 🇮🇲
すーだん	すーだん 🇸🇩
しゅうきょう	しゅうきょう ☦️ ☪️ ☯️ ☸️ ⛩️ ⛪️ ✝️ ✡️ 📿 🕉️ 🕋 🕌 🕍 🕎 🛐 🛕 🪯
なみ	なみ 〰️ 🌊 🏄️
ちゃくりく	ちゃくりく 🛬
したむきさんかく	したむきさんかく 🔻 🔽
ハサミ	ハサミ ✂️
サのマーク	サのマーク 🈂️
どんっ	どんっ 💥 💥
だんぼーる	だんぼーる 📦️
英語「ＡＢＣ」	英語「ＡＢＣ」 🔤
しろしかくちゅう	しろしかくちゅう ◽️
アスクレピオスの杖	アスクレピオスの杖 ⚕️
かざり	かざり ✳️ ✴️
ＴＶ	ＴＶ 📺️
ドル円	ドル円 💱
しかめつらのおんな	しかめつらのおんな 🙍‍♀️
りんね	りんね 🐦‍🔥
ミリアム	ミリアム 🪬
いきをはくかお	いきをはくかお 😮‍💨
かざん	かざん 🌋
拾う	拾う 🫳
白鳥	白鳥 🦢
いおりてん	いおりてん 〽️ 〽️
よぞら	よぞら 🌌
ちゅうせいてき	ちゅうせいてき 🧑 🧑‍🦰 🧑‍🦱 🧑‍🦲 🧑‍🦳 🧒 🧓
礼拝	礼拝 🛐
右カーブ矢印	右カーブ矢印 ↩️
ぎしゅ	ぎしゅ 🦾
こうしんりょう	こうしんりょう 🌶️
えいとぼーる	えいとぼーる 🎱
わかばまーく	わかばまーく 🔰
しんぴてき	しんぴてき 🧝
とかい	とかい 🌁 🌆 🏙️ 🏢
国旗（フランス）	国旗（フランス） 🇫🇷
格闘	格闘 🤼 🤼‍♀️ 🤼‍♂️
雲形の吹き出し	雲形の吹き出し 💭
しもん｜かんしき｜せいたいにんしょう｜せきゅりてぃ	しもん｜かんしき｜せいたいにんしょう｜せきゅりてぃ 🫆
ジョギングシューズ	ジョギングシューズ 👟
ヒンドゥー教	ヒンドゥー教 🕉️ 🪷
むっとしている男	むっとしている男 🙍‍♂️
せねがる	せねがる 🇸🇳
うんめい	うんめい 🔮
とかげ	とかげ 🦎
パスポートコントロール	パスポートコントロール 🛂
かんたんふぎもんふ	かんたんふぎもんふ ⁉️
こっかく	こっかく 🦴 🩻
じょせいとおんなのことおとこのこのかぞく	じょせいとおんなのことおとこのこのかぞく 👩‍👧‍👦
グーグー	グーグー 💤 😴 🛌
とかす	とかす 🫕
演芸	演芸 🎭️
小豆	小豆 🫘
idまーく	idまーく 🆔
夕方街並み	夕方街並み 🌆
常緑樹	常緑樹 🌲
瞑想	瞑想 🧘 🧘‍♀️ 🧘‍♂️
はいいろ	はいいろ 🩶
くだもの	くだもの 🍅 🍇 🍈 🍉 🍊 🍋 🍋‍🟩 🍌 🍍 🍎 🍏 🍐 🍑 🍒 🍓 🥑 🥝 🥥 🥭 🫐
銀貨	銀貨 🪙
車輪	車輪 🛞
簿記	簿記 🧾
ドードー	ドードー 🦤
ドクロ	ドクロ ☠️ 💀
したぎ	したぎ 🩲 🩳
ゆうとうせい	ゆうとうせい 🤓
八端十字架	八端十字架 ☦️
コンピューター	コンピューター ⌨️ 💻️ 💽 💾 💿️ 🖥️ 🖨️ 🖱️ 🖲️
前のシーン	前のシーン ⏮️
号泣	号泣 😭
きーりんぐしょとう	きーりんぐしょとう 🇨🇨
はいびすかす	はいびすかす 🌺
たてたなかゆび	たてたなかゆび 🖕
びくーな	びくーな 🦙
おんみつ	おんみつ 🥷
きいろいしかく	きいろいしかく 🟨
傷心	傷心 ❤️‍🩹
旅行かばん	旅行かばん 🧳
女性と女性のカップル	女性と女性のカップル 👩‍❤️‍👩
アンティグア・バーブーダ	アンティグア・バーブーダ 🇦🇬
手当て	手当て 🩹
びでお	びでお 📹️ 📺️ 📼 📽️
成人男性	成人男性 👨
せいぶつがく	せいぶつがく 🧫 🧬
けいりん	けいりん 🚴 🚴‍♀️ 🚴‍♂️
モヒート	モヒート 🍋‍🟩
じょせいとじょせいとおとこのことおとこのこのかぞく	じょせいとじょせいとおとこのことおとこのこのかぞく 👩‍👩‍👦‍👦
にゅうしゅっこく	にゅうしゅっこく 🛂
上下両方向矢印	上下両方向矢印 ↕️
えんどうまめ	えんどうまめ 🫛
すりっぽん	すりっぽん 🥿
いたい	いたい 🤕
しゃんぷー	しゃんぷー 🧴
がいちゅう	がいちゅう 🪰 🪳
100点	100点 💯
キックボード	キックボード 🛴
しゅのーけりんぐ	しゅのーけりんぐ 🤿
ひざまずく	ひざまずく 🧎 🧎 🧎‍♀️ 🧎‍♀️ 🧎‍♀️‍➡️ 🧎‍♀️‍➡️ 🧎‍♂️ 🧎‍♂️ 🧎‍♂️‍➡️ 🧎‍♂️‍➡️ 🧎‍➡️ 🧎‍➡️
さかな	さかな 🎣 🐟️ 🐠 🐡 🦈
いすらえる	いすらえる 🇮🇱
顔のある上弦の月	顔のある上弦の月 🌛
とうろくしょうひょうまーく	とうろくしょうひょうまーく ®️
樹木	樹木 🪵
げっぺい	げっぺい 🥮
こねこ	こねこ 🐱
おとしより	おとしより 👴 👵 🧓
寒い顔	寒い顔 🥶
競走馬	競走馬 🏇 🐎
ぼつわな	ぼつわな 🇧🇼
チェックマーク１	チェックマーク１ ✔️
チェックマーク２	チェックマーク２ ✅️
台風（うずまき）	台風（うずまき） 🌀
アップルパイ	アップルパイ 🥧
ジニー	ジニー 🧞
さつえい	さつえい 🎥
あかげ	あかげ 👨‍🦰 👩‍🦰 🦰 🧑‍🦰
えんばん	えんばん 🥏
ビデオカセット	ビデオカセット 📼
すなどけい	すなどけい ⌛️ ⏳️
ゆうぐ	ゆうぐ 🛝
勝ち誇り	勝ち誇り 😤
かねぶくろ	かねぶくろ 💰️
GLBTQ	GLBTQ 🌈 🌈
掘る	掘る 🪏
きょうりゅう	きょうりゅう 🦕 🦖
あかり	あかり 💡 🔦 🕯️ 🪔
よが	よが 🧘 🧘‍♀️ 🧘‍♂️
凧揚げ	凧揚げ 🪁
どるえん	どるえん 💱
ろーどれーす	ろーどれーす 🚴 🚴‍♀️ 🚴‍♂️
けんせつさぎょういん	けんせつさぎょういん 👷
よじ	よじ 🕓️
ふらっとぶれっど	ふらっとぶれっど 🫓
ゆうひ	ゆうひ 🌆 🌇
ちょっとまって	ちょっとまって 🫷 🫸
かいはつしゃ	かいはつしゃ 👨‍💻 👩‍💻 🧑‍💻
でも	でも 🪧
追悼	追悼 🪦
ソーセージ	ソーセージ 🌭
8じ30ふん	8じ30ふん 🕗️ 🕣️
ダイア	ダイア ♦️ 💍 💎 💠 🔶 🔷 🔸 🔹
ブリーフケース(ハンドバック）	ブリーフケース(ハンドバック） 👜
かこう	かこう 📉
よる	よる 🌃 🌆 🌉 🌠
じょせいとおんなのことおんなのこのかぞく	じょせいとおんなのことおんなのこのかぞく 👩‍👧‍👧
ブリーフケース	ブリーフケース 💼
てがかり	てがかり 🗝️
さんぐらす	さんぐらす 🕶️ 😎
きすまーく	きすまーく 💋
オクトパス	オクトパス 🐙
満室	満室 🈵
なんきょく	なんきょく 🇦🇶
らっぷさんど	らっぷさんど 🌯 🥙
ひょうしつきのーと	ひょうしつきのーと 📔
トリュフ	トリュフ 🍄‍🟫
ばるーん	ばるーん 🎈
ゆーふぉー	ゆーふぉー 👽️ 🛸
オートリクシャー	オートリクシャー 🛺
ぶどう	ぶどう 🍇 🍇 🥋
ダイス	ダイス 🎲
爬虫類	爬虫類 🐊 🐍 🐢 🦎
口が開いた顔	口が開いた顔 😮
歴史	歴史 🏛️
通貨	通貨 💱 💲 💴 💵 💶 💷
鉢植え	鉢植え 🪴
再読み込み	再読み込み 🔃
献血	献血 🩸
ダイヤ	ダイヤ ♦️ 💍 💎 💠 🔶 🔷 🔸 🔹
メガホン	メガホン 📢 📣
けしょう	けしょう 💄
バイソン	バイソン 🦬
超悪玉	超悪玉 🦹
丸に斜め線	丸に斜め線 🚫
とらっく	とらっく 🚚 🚛 🛻
すうがく	すうがく 🟰
らんどせる	らんどせる 🎒
恋人	恋人 👨‍❤️‍👨 👩‍❤️‍👨 👩‍❤️‍👩 👫 👬 👭 💑 🧑‍🤝‍🧑
フラットブレッド	フラットブレッド 🫓
ちょさくけんまーく	ちょさくけんまーく ©️
おばあちゃん	おばあちゃん 👵 👵
まーく	まーく 📑
らーてる	らーてる 🦡
かりうむ	かりうむ 🍌
ユーロ	ユーロ 💶
ビーチ	ビーチ ⛱️ 🌴 🏖️ 👙
お手上げ	お手上げ 🤷 🤷‍♀️ 🤷‍♂️
青い丸	青い丸 🔵
ぶらつく	ぶらつく 🚶 🚶 🚶‍➡️ 🚶‍➡️
ビート	ビート 🪘
左下矢印	左下矢印 ↙️
すとろーかっぷ	すとろーかっぷ 🥤
巨岩	巨岩 🪨
こまった	こまった ☹️ 😖 😟 😥 🙁
白枠四角	白枠四角 🔳
ビーフ	ビーフ 🥩
青リンゴ	青リンゴ 🍏
ビーズ	ビーズ 🧿
ミミズク	ミミズク 🦉
食事２	食事２ 🍖
ゲーム	ゲーム 🀄️ 🎮️ 🎰 🎲 🎴 👾 🕹️ 🥌
山を登る男	山を登る男 🧗‍♂️
サウナ	サウナ 🧖 🧖‍♀️ 🧖‍♂️
ひらいたゆうびんうけ	ひらいたゆうびんうけ 📬️ 📭️
あいでぃー	あいでぃー 🆔
曇り時々晴れ	曇り時々晴れ ⛅️
るくせんぶるく	るくせんぶるく 🇱🇺
ビール	ビール 🍺 🍻
べなん	べなん 🇧🇯
精霊	精霊 🧞 🧞‍♀️ 🧞‍♂️
たいよう	たいよう ☀️ ⛅️ 🌄 🌅 🌇 🌞 🌤️ 🌥️ 🌦️
物理学者	物理学者 🧑‍🔬
ダーツ	ダーツ 🎯
ぴーしー	ぴーしー ⌨️
立つ男	立つ男 🧍‍♂️
みなみあふりか	みなみあふりか 🇿🇦
男性の溶接工	男性の溶接工 👨‍🏭
零時	零時 🕛️
れーす	れーす 🏁 🏎️
口を尖らせた男	口を尖らせた男 🙎‍♂️
ごせん	ごせん 🎼
けつえきがたおーがた	けつえきがたおーがた 🅾️
通関	通関 🛃
こんぴゅーた	こんぴゅーた 👨‍💻 👩‍💻 💻️ 🧑‍💻
こんやくゆびわ	こんやくゆびわ 💍
おーけすとら	おーけすとら 🪈 🪉
ふぃんらんど	ふぃんらんど 🇫🇮
わらいころげる	わらいころげる 🤣
ゆうたいるい	ゆうたいるい 🦘
タダ	タダ 🆓 🈚️
ろっくおん	ろっくおん 🔒️ 🤘
うずまき	うずまき 🌀 🍥 😵‍💫
ワイシャツ	ワイシャツ 👔
刺繍	刺繍 🪡
タイ	タイ 🇹🇭
白杖をついた男性	白杖をついた男性 👨‍🦯 👨‍🦯‍➡️
ろっくおふ	ろっくおふ 🔓️
おとなひとり	おとなひとり 🧑‍🧒 🧑‍🧒‍🧒
北東	北東 ↗️
有害物質	有害物質 ☣️
しぜん	しぜん 🌊 🏞️
ほえー	ほえー 😩
えすとにあ	えすとにあ 🇪🇪
あるめにあ	あるめにあ 🇦🇲
弁当	弁当 🍱 🥡
タグ	タグ 🏷️ 🔖
1きょくりぴーとぼたん	1きょくりぴーとぼたん 🔂
シャープダイヤル	シャープダイヤル #️⃣
タキシードの女性	タキシードの女性 🤵‍♀️
ＮＥＷ	ＮＥＷ 🆕 🆕
タコ	タコ 🐙
店舗	店舗 🏬
乾電池	乾電池 🔋
免許証	免許証 🪪
次のシーン	次のシーン ⏭️
こるく	こるく 🍾
ほこうほじょ	ほこうほじょ 🩼
じてんしゃにのるおとこ	じてんしゃにのるおとこ 🚴‍♂️
ガイアナ	ガイアナ 🇬🇾
寄生虫	寄生虫 🪱
うつろなめ	うつろなめ 🥴
せんたく	せんたく 🧺
ベネズエラ	ベネズエラ 🇻🇪
走る	走る 🏃 🏃‍♀️ 🏃‍♀️‍➡️ 🏃‍➡️ 💨
朝日	朝日 🌄 🌅
さつまいも	さつまいも 🍠
すぱい	すぱい 🕵️ 🥷
でっどりふと	でっどりふと 🏋️
ハートにリボン	ハートにリボン 💝
保護メガネ	保護メガネ 🥽
すたじあむ	すたじあむ 🏟️
じーん	じーん 🥲 🥲
小雨	小雨 🌂
おやき	おやき ☎️
エンターテイナー	エンターテイナー 👨‍🎤 👩‍🎤
ジョッキ	ジョッキ 🍺 🍻
歴史的な建物	歴史的な建物 🏛️
こいぶみ	こいぶみ 💌
おやこ	おやこ 👨‍👦 👨‍👦‍👦 👨‍👧 👨‍👧‍👦 👨‍👧‍👧 👨‍👨‍👦 👨‍👨‍👦‍👦 👨‍👨‍👧 👨‍👨‍👧‍👦 👨‍👨‍👧‍👧 👨‍👩‍👦 👨‍👩‍👦‍👦 👨‍👩‍👧 👨‍👩‍👧‍👦 👨‍👩‍👧‍👧 👩‍👦 👩‍👦‍👦 👩‍👧 👩‍👧‍👦 👩‍👧‍👧 👩‍👩‍👦 👩‍👩‍👦‍👦 👩‍👩‍👧 👩‍👩‍👧‍👦 👩‍👩‍👧‍👧 👪️ 🧑‍🧑‍🧒 🧑‍🧑‍🧒‍🧒 🧑‍🧒 🧑‍🧒‍🧒
ベッドに寝る人	ベッドに寝る人 🛌
とろりーばす	とろりーばす 🚃 🚋 🚎
太字のチェック	太字のチェック ✔️
女性の溶接工	女性の溶接工 👩‍🏭
つえ	つえ 🦯 🦯 🩼 🪄 🪄
なんとう	なんとう ↘️
せっけん	せっけん 🧼 🫧
つき	つき 🈷️ 🌑 🌒 🌓 🌔 🌕️ 🌖 🌗 🌘 🌙 🌚 🌛 🌜️ 🌝 🎑
登録商標マーク	登録商標マーク ®️
おやつ	おやつ 🧁 🧁
ちょうあくだま	ちょうあくだま 🦹
救急車	救急車 🚑️
おっと	おっと 🤭 🤭
えふわん	えふわん 🏎️
数字の入力	数字の入力 🔢
しょうしん	しょうしん ❤️‍🩹
ごるふをするおとこ	ごるふをするおとこ 🏌️‍♂️
すぱな	すぱな 👨‍🔧 👩‍🔧 🔧 🛠️ 🧑‍🔧
りょくちゃ	りょくちゃ 🍵
祝日	祝日 🎌
シマリス	シマリス 🐿️
しんぶん	しんぶん 📰 🗞️
植物	植物 ☘️ 🌵 🌷 🌸 🌹 🌺 🌼 🍀 🏵️ 💐 🪴 🪻
びーがた	びーがた 🅱️
ベーカリー	ベーカリー 🍞 🥐 🥖 🥯 🧁
つめ	つめ 💅
目を閉じてキス	目を閉じてキス 😚
帽子	帽子 ⛑️ 🎓️ 🎩 👒 👳 🤠 🥳 🧑‍🎄 🧢
泣き顔	泣き顔 😢 😩 😭 🥹
レストラン	レストラン 🍳 🍴
土星	土星 🪐
つり	つり 🎣 🐟️
つな	つな 🪢
理容室	理容室 💇 💇‍♂️ 💈
めきしこりょうり	めきしこりょうり 🌮 🌯
せんとくりすとふぁーねーゔぃす	せんとくりすとふぁーねーゔぃす 🇰🇳
つの	つの 👿 😈 🪲 🪲
祝日の旗	祝日の旗 🎌
吹き出しの目	吹き出しの目 👁️‍🗨️
パンプキンパイ	パンプキンパイ 🥧
かんおけ	かんおけ ⚰️
泣き笑い	泣き笑い 😂 🤣
注意	注意 ⚠️
きつね	きつね 🤘 🦊
つぼ	つぼ 🍯 🏺
ＮＧ	ＮＧ 🆖 👎️ 🙅
枯れ木	枯れ木 🪾
うしのかお	うしのかお 🐮
めをむく	めをむく 🙄
スノーボーダー	スノーボーダー 🏂️
黒旗	黒旗 🏴
男性の医者	男性の医者 👨‍⚕️
キューバ	キューバ 🇨🇺
ニンニク	ニンニク 🧄
がくしゃ	がくしゃ 🎓️
ぽすと	ぽすと 📪️ 📫️ 📬️ 📭️ 📮
すこしだけ	すこしだけ 🤏
わかれ	わかれ 💔
いまちづき	いまちづき 🌖
さぼてんのあるさばく	さぼてんのあるさばく 🏜️
眼鏡	眼鏡 👓️ 🕶️ 😎
ふぇんしんぐ	ふぇんしんぐ 🤺
せかい	せかい 🌍️ 🌎️ 🌏️ 🗺️
おんりょうしょう	おんりょうしょう 🔉
げんかい	げんかい 😫
車両進入禁止	車両進入禁止 ⛔️
オーケー	オーケー 🆗 👌 👍️ 🙆 🙆‍♀️ 🙆‍♂️ 🫡
こうじちゅう	こうじちゅう 🚧
お面	お面 👹 👺
煙突	煙突 🏭️
静かに	静かに 🤫 🫢
すこしこまったかお	すこしこまったかお 🙁
じょせいとだんせいできす	じょせいとだんせいできす 👩‍❤️‍💋‍👨
コインロッカー	コインロッカー 🛅
サイコロ	サイコロ 🎲
投げる	投げる 🤾 🤾‍♀️
郵便	郵便 ✉️ 🏣 🏤 📧 📮 📯
しゃんぱん	しゃんぱん 🍾 🥂
吐く	吐く 🤮
まうす	まうす 🐁 🖱️
ディスク	ディスク 💾 💿️ 📀
目覚まし時計（１０時）	目覚まし時計（１０時） 🕙️
中華人民共和国マカオ特別行政区	中華人民共和国マカオ特別行政区 🇲🇴
赤リンゴ	赤リンゴ 🍎
あまのがわ	あまのがわ 🌌
ディスコ	ディスコ 🪩
てこんどー	てこんどー 🥋
くらっかー	くらっかー 🎉
セントビンセント及びグレナディーン諸島	セントビンセント及びグレナディーン諸島 🇻🇨
指定マーク	指定マーク 🈯️
タンゴ	タンゴ 💃 🕺
はなかざり	はなかざり 🏵️
はなふだ	はなふだ 🎴
げんかん	げんかん 🚪
ヒロイン	ヒロイン 🦸 🦸‍♀️
えかき	えかき 🧑‍🎨
ばたー	ばたー 🧈
満席	満席 🈵
スマートフォン	スマートフォン 📱 📲 📳 📴 📶
盗み見	盗み見 🫣
にうえ	にうえ 🇳🇺
糸巻き	糸巻き 🧵
いちじていしぼたん	いちじていしぼたん ⏯️ ⏸️
みゅーと	みゅーと 🔇 🔕
西洋の郵便局	西洋の郵便局 🏤
お別れ	お別れ 🫂
小顔	小顔 👧
永遠	永遠 ♾️
まれーしあ	まれーしあ 🇲🇾
登山	登山 🧗 🧗‍♀️ 🧗‍♂️
べーかりー	べーかりー 🍞 🥐 🥖 🥯 🧁
鳥居	鳥居 ⛩️
首巻き	首巻き 🧣
はすのはな	はすのはな 🪷
とびちったぺんき	とびちったぺんき 🫟
えすおーえすまーく	えすおーえすまーく 🆘
果物	果物 🍅 🍇 🍈 🍉 🍊 🍋 🍋‍🟩 🍌 🍍 🍎 🍏 🍐 🍑 🍒 🍓 🥑 🥝 🥥 🥭 🫐
かっぷけーき	かっぷけーき 🧁
ゴールド	ゴールド 🥇
Tシャツ	Tシャツ 👕
せいほうけい	せいほうけい ▪️ ▫️ ◻️ ◼️ ◽️ ◾️ ⬛️ ⬜️ 🔲 🔳 🟥 🟦 🟧 🟨 🟩 🟪 🟫
もんごる	もんごる 🇲🇳
食パン	食パン 🍞
おーけーのぽーずをするおんな	おーけーのぽーずをするおんな 🙆‍♀️
煙草	煙草 🚬 🚭️
うすわらいをするかお	うすわらいをするかお 😏
あらいぐま	あらいぐま 🦝
包丁	包丁 🔪
表情（嬉しい）	表情（嬉しい） 😄
しろしかくしょう	しろしかくしょう ▫️
チュー（ネコ）	チュー（ネコ） 😽
幕の内	幕の内 🍱
えくすくらめーしょんまーく	えくすくらめーしょんまーく ‼️ ❕️ ❗️ ❣️
巣作り	巣作り 🪹 🪺
禁煙	禁煙 🚭️
ほうしんじょうたい	ほうしんじょうたい 😶‍🌫️
さうすじょーじあ・さうすさんどうぃっちしょとう	さうすじょーじあ・さうすさんどうぃっちしょとう 🇬🇸
だんせいとおんなのことおとこのこのかぞく	だんせいとおんなのことおとこのこのかぞく 👨‍👧‍👦
てのこう	てのこう 🤚
サーフィンする男	サーフィンする男 🏄‍♂️
チーズフォンデュ	チーズフォンデュ 🫕
らべんだー	らべんだー 🪻
怪我	怪我 🩼
ベーコン	ベーコン 🥓
ぶるきなふぁそ	ぶるきなふぁそ 🇧🇫
調理器具	調理器具 🔪
男の妖精	男の妖精 🧚‍♂️
ストラディバリウス	ストラディバリウス 🎻
満月	満月 🌕️ 🌝
じょうりょくじゅ	じょうりょくじゅ 🌲
北極	北極 🐻‍❄️
こいびと	こいびと 👨‍❤️‍👨 👩‍❤️‍👨 👩‍❤️‍👩 👫 👬 👭 💑 🧑‍🤝‍🧑
あせんしょんとう	あせんしょんとう 🇦🇨
5時半	5時半 🕠️
ぐらふうえむき	ぐらふうえむき 📈
exclamation×2	exclamation×2 ‼️
じょせいとじょせいのかっぷる	じょせいとじょせいのかっぷる 👩‍❤️‍👩
おーけーのぽーずをするひと	おーけーのぽーずをするひと 🙆
うわのそら	うわのそら 😶‍🌫️
検索	検索 🔍️ 🔎
下弦	下弦 🌗
じゅうどう	じゅうどう 🥋
祝杯	祝杯 🥂
異星人	異星人 👽️ 👾
運転免許証	運転免許証 🪪
ぽーとべろー	ぽーとべろー 🍄‍🟫
てにもつあずかり	てにもつあずかり 🛅
くもりときどきはれ	くもりときどきはれ ⛅️
生命	生命 🧬
スペシャル	スペシャル 🩷
ぷらいばしー	ぷらいばしー 🔏
茶器	茶器 🫖
もうどうけん	もうどうけん 🦮
嘔吐する顔	嘔吐する顔 🤮
レース	レース 🏁 🏎️
バツ１	バツ１ ❌️
けしょうすい	けしょうすい 🧴
バツ２	バツ２ ❎️
ラブホテル	ラブホテル 🏩
雲の中の顔	雲の中の顔 😶‍🌫️
紙吹雪	紙吹雪 🎊
すわる	すわる 🧎 🧎‍♀️ 🧎‍♀️‍➡️ 🧎‍♂️ 🧎‍♂️‍➡️ 🧎‍➡️
ちず	ちず 📍 🗺️ 🗾
停止	停止 ⏹️
ばみゅーだ	ばみゅーだ 🇧🇲
ブーイング	ブーイング 👎️
イコール	イコール 🟰
おめん	おめん 👹 👺
もも	もも 🍑
ちっ	ちっ 🫦
もや	もや 🌁 🌁
黙る	黙る 🙊
ナミビア	ナミビア 🇳🇦
結び目	結び目 🪢
校舎	校舎 🏫
フェイスマッサージ中の人	フェイスマッサージ中の人 💆
うわぎ	うわぎ 🥼
ちり	ちり 🇨🇱
もり	もり 🌲 🌳
すのぼ	すのぼ 🏂️
つまらない	つまらない 😒 😒
ばくやく	ばくやく 🧨
温泉マーク	温泉マーク ♨️
りひてんしゅたいん	りひてんしゅたいん 🇱🇮
きもち	きもち 🩷
りりく	りりく 🛫
みみのふじゆうなだんせい	みみのふじゆうなだんせい 🧏‍♂️
空中浮遊	空中浮遊 🕴️
父親	父親 👨‍🍼 🧑‍🍼
うわめ	うわめ 🙄
ハンバーガー（ファーストフード）	ハンバーガー（ファーストフード） 🍔
ダイナマイト	ダイナマイト 🧨
カヌー	カヌー 🚣 🚣‍♀️ 🚣‍♂️ 🛶
きもの	きもの 👘
くらんぷ	くらんぷ 🗜️
ラップトップ	ラップトップ 💻️
チョウ	チョウ 🦋
ひとさしゆびとこゆびをたてたて	ひとさしゆびとこゆびをたてたて 🤘
じょせいかがくしゃ	じょせいかがくしゃ 👩‍🔬
野菜	野菜 🌰 🌶️ 🌽 🍄 🍅 🍆 🍈 🍉 🥑 🥒 🥔 🥕 🥜 🥦 🧄 🧅 🫑 🫛
どるふぃん	どるふぃん 🐬
ぎりしゃ	ぎりしゃ 🇬🇷
こまったかお	こまったかお ☹️ 😧
昆虫	昆虫 🐜 🦋 🦗 🪲
チョキ	チョキ ✌️
ベール	ベール 👰 👰‍♀️ 👰‍♂️ 🧕
じどうしゃしょうめん	じどうしゃしょうめん 🚘️
チョコ	チョコ 🍫 🫕
こうきど	こうきど 🔆
時計（１２時）	時計（１２時） 🕛️
9時30分	9時30分 🕤️
ろくおんろくがぼたん	ろくおんろくがぼたん ⏺️
上矢印	上矢印 ⬆️
コントロールつまみ	コントロールつまみ 🎛️
我慢	我慢 😣
らじおぼたん	らじおぼたん 🔘
めーるそうしん	めーるそうしん 📩
路面電車	路面電車 🚊 🚋 🚎
かおのあるたいよう	かおのあるたいよう 🌞
ぶーいんぐ	ぶーいんぐ 👎️
ぶらうんまっしゅるーむ	ぶらうんまっしゅるーむ 🍄‍🟫
らーめん	らーめん 🍜
ほうたいをまいたはーと	ほうたいをまいたはーと ❤️‍🩹
くろすしたけん	くろすしたけん ⚔️
だんせいとおんなのことおんなのこのかぞく	だんせいとおんなのことおんなのこのかぞく 👨‍👧‍👧
異議	異議 🪧
動く目玉	動く目玉 👀
クローバー	クローバー ☘️ ♣️ 🍀
ヤモリ	ヤモリ 🦎
ＦＲＥＥ	ＦＲＥＥ 🆓
ブルネイ	ブルネイ 🇧🇳
きんぱつのじょせい	きんぱつのじょせい 👱‍♀️
かみとえんぴつ	かみとえんぴつ 📝
フェニックス	フェニックス 🐦‍🔥
茶色い靴	茶色い靴 🥾
すきーぶーつ	すきーぶーつ 🎿
もくざい	もくざい 🪵
バランス演技	バランス演技 🤹 🤹‍♂️
でんちぎれすんぜん	でんちぎれすんぜん 🪫
ぷーどる	ぷーどる 🐩
古い鍵	古い鍵 🗝️
クリッパートン島	クリッパートン島 🇨🇵
のみみず	のみみず 🚰
なべりょうり	なべりょうり 🍲
ふんか	ふんか 🌋
X線	X線 🩻
宇宙人	宇宙人 👽️ 👾 🛸
いんさつき	いんさつき 🖨️
俳優	俳優 🎭️ 👨‍🎤 👩‍🎤
クレーン	クレーン 🏗️
はーとのや	はーとのや 💘
ほっとどっぐ	ほっとどっぐ 🌭
飲み屋	飲み屋 🏮
楽譜	楽譜 🎼
2にん	2にん 👥
てぃーるぶるー	てぃーるぶるー 🩵
あんないするおとこ	あんないするおとこ 💁‍♂️
ゴルフをする人	ゴルフをする人 🏌️
目を開けて口に手を当てた顔	目を開けて口に手を当てた顔 🫢
ゆうわく	ゆうわく 🫦
ステッパー	ステッパー 🪜
ときどき曇り	ときどき曇り ⛅️
訴えるような顔	訴えるような顔 🥺
天の川	天の川 🌌
寂しい	寂しい 😢
すづくり	すづくり 🪹 🪺
てつや	てつや 🫩
はぐするひと	はぐするひと 🫂
目がぐるぐる	目がぐるぐる 😵‍💫
ふんっ	ふんっ 😤 😤
ガススタンド	ガススタンド ⛽️
ペア	ペア 👯
ハイヒール	ハイヒール 👠
熱帯魚	熱帯魚 🐠
はみがき	はみがき 🪥
満点	満点 💯
えふでぃー	えふでぃー 💾
硬い	硬い 🪨
のみや	のみや 🏮
大豆	大豆 🫛
親指	親指 👍️
スパ	スパ 💆 🧖
ぐっど	ぐっど ⤴️ 👍️
ペケ	ペケ ✖️ ❌️ ❎️
ベーグル	ベーグル 🥯
ぴくにっく	ぴくにっく 🧺
わるいひと	わるいひと 🦹
ゴミ箱	ゴミ箱 🗑️ 🚮
ヒヨコマメ	ヒヨコマメ 🧆
さあね	さあね 🤷 🤷 🤷‍♀️ 🤷‍♀️ 🤷‍♂️ 🤷‍♂️
すこっとらんど	すこっとらんど 🏴󠁧󠁢󠁳󠁣󠁴󠁿
まきがい	まきがい 🐚
さんだる	さんだる 👡 🩴
子犬の目	子犬の目 🥺
はろう	はろう 🌊
ぴーまーく	ぴーまーく 🅿️
たらーっ	たらーっ 💧 💧
12じ30ふん	12じ30ふん 🕧️
格闘技	格闘技 🥋
なまはげ	なまはげ 👹 👹
Mail	Mail 📩
軽トラック	軽トラック 🛻
通水カップ	通水カップ 🪠
ペン	ペン ✒️ 🖊️ 🖋️
ひたいにてをあてるおんな	ひたいにてをあてるおんな 🤦‍♀️
SOSマーク	SOSマーク 🆘
じょうげやじるし	じょうげやじるし ↕️
やじるしじょうげ	やじるしじょうげ ↕️
カップルとハート	カップルとハート 👨‍❤️‍👨 👩‍❤️‍👨 👩‍❤️‍👩 💑
いんどねしあ	いんどねしあ 🇮🇩
注射	注射 💉
水鉄砲	水鉄砲 🔫
見ざる	見ざる 🙈
菌類	菌類 🍄 🍄‍🟫
太陽	太陽 ☀️ ⛅️ 🌄 🌅 🌇 🌞 🌤️ 🌥️ 🌦️
保育園	保育園 📛
すいきゅうをするおんな	すいきゅうをするおんな 🤽‍♀️
そうじゅうし	そうじゅうし 👨‍✈️ 👩‍✈️ 🧑‍✈️
ぞう	ぞう 🐘 🐘 🗿
たっている	たっている 🧍
肉団子	肉団子 🧆
カエデ	カエデ 🍁
タマレス	タマレス 🫔
モナコ	モナコ 🇲🇨
おまーん	おまーん 🇴🇲
まっさーじ	まっさーじ 💆 💆‍♀️ 💆‍♂️
グレナダ	グレナダ 🇬🇩
あんないするひと	あんないするひと 💁
三日月	三日月 ☪️ 🌒 🌘 🌙
おどるおんな	おどるおんな 💃
禁止	禁止 ⛔️ 🈲 🔞 🙅 🙅‍♂️ 🚫 🚭️ 🚯 🚱 🚳 🚷
しょっき	しょっき 🍴 🍽️ 🥄
おそれ	おそれ 🫢 🫢
しょっく	しょっく 😱 🙀 🤦 🤦‍♀️ 🤦‍♂️ 🤯 🫨
らべる	らべる 🏷️
とうろくしょうひょう	とうろくしょうひょう ®️
親子	親子 👨‍👦 👨‍👦‍👦 👨‍👧 👨‍👧‍👦 👨‍👧‍👧 👨‍👨‍👦 👨‍👨‍👦‍👦 👨‍👨‍👧 👨‍👨‍👧‍👦 👨‍👨‍👧‍👧 👨‍👩‍👦 👨‍👩‍👦‍👦 👨‍👩‍👧 👨‍👩‍👧‍👦 👨‍👩‍👧‍👧 👩‍👦 👩‍👦‍👦 👩‍👧 👩‍👧‍👦 👩‍👧‍👧 👩‍👩‍👦 👩‍👩‍👦‍👦 👩‍👩‍👧 👩‍👩‍👧‍👦 👩‍👩‍👧‍👧 👪️ 🧑‍🧑‍🧒 🧑‍🧑‍🧒‍🧒 🧑‍🧒 🧑‍🧒‍🧒
北マケドニア	北マケドニア 🇲🇰
デリバリー	デリバリー 🥡
ねじり	ねじり 🥨 🥨
ききみみ	ききみみ 👂️
トロリーバス	トロリーバス 🚃 🚋 🚎
山岳	山岳 ⛰️
ねじれ	ねじれ 🪢 🪢
じどうしゃ	じどうしゃ 🚗 🚘️ 🚙 🛞 🛻
草食恐竜	草食恐竜 🦕
ぶりーふけーす	ぶりーふけーす 💼
ふらっとしゅーず	ふらっとしゅーず 🥿
女性科学者	女性科学者 👩‍🔬
眠っている顔	眠っている顔 😪
さいせい／いちじていしぼたん	さいせい／いちじていしぼたん ⏯️
かいてんするはーと	かいてんするはーと 💞
スミレ色	スミレ色 🪻
ばすけ	ばすけ ⛹️ ⛹️‍♀️ ⛹️‍♂️ 🏀
みだしなみ	みだしなみ 🪞
たちいりきんし	たちいりきんし ⛔️
けいたいでんわ	けいたいでんわ 📱 📲 📳 📴 📶
カエル	カエル 🐸
えいがた	えいがた 🅰️
埋葬	埋葬 ⚰️ ⚱️ 🪦
かおく	かおく 🏠️
衝撃	衝撃 💥
しょっと	しょっと 🥃
のうみそ	のうみそ 🧠
イスラエル	イスラエル 🇮🇱
おとなひとりとこどもひとりのかぞく	おとなひとりとこどもひとりのかぞく 🧑‍🧒
マレーシア	マレーシア 🇲🇾
複数の音符	複数の音符 🎶
失恋	失恋 💔
パンケーキ	パンケーキ 🥞
〒♪&ぱーせんと	〒♪&ぱーせんと 🔣
包む手	包む手 🤲
マジック	マジック 🪄
襟巻き	襟巻き 🧣
かおり	かおり 🧄
きょだいせいりょく	きょだいせいりょく 🦸
ばくだん	ばくだん 💣️
いんでっくす	いんでっくす 🗂️
イモムシ	イモムシ 🐛
まにきゅあをぬるて	まにきゅあをぬるて 💅
ゆうびんらっぱ	ゆうびんらっぱ 📯
にゅーす	にゅーす 📰 🗞️
大人二人と子供二人の家族	大人二人と子供二人の家族 🧑‍🧑‍🧒‍🧒
ごるふぁー	ごるふぁー 🏌️ 🏌️‍♀️ 🏌️‍♂️
ぺーじまーく	ぺーじまーく 📑
リサイクルマーク	リサイクルマーク ♻️
ひだりやじるし	ひだりやじるし ⬅️
にゅーかれどにあ	にゅーかれどにあ 🇳🇨
はろー	はろー 👋
どくたー	どくたー 👨‍⚕️ 👩‍⚕️ 😷
じゅしん	じゅしん 📥️ 📨 📩 📲
ますくめろん	ますくめろん 🍈
空き瓶	空き瓶 🫙
だいどうげい	だいどうげい 🤹 🤹‍♀️ 🤹‍♂️
登山鉄道	登山鉄道 🚞
ごめんなさい	ごめんなさい 🙇 🙇 🙇‍♀️ 🙇‍♀️ 🙇‍♂️ 🙇‍♂️ 🙏 🙏
1人	1人 👤
ゆるして	ゆるして 🙇
フェイスマッサージ中の女	フェイスマッサージ中の女 💆‍♀️
案内する人	案内する人 💁
パッケージ	パッケージ 📦️
美容室	美容室 💇 💇‍♀️ 💇‍♂️ 💈
爆発物	爆発物 🧨
南スーダン	南スーダン 🇸🇸
サングラス	サングラス 🕶️ 😎
つーるぼっくす	つーるぼっくす 🧰
ダイビングマスク	ダイビングマスク 🤿
スリッポン	スリッポン 🥿
西洋ナシ	西洋ナシ 🍐
ひので	ひので 🌄 🌅
じょぎんぐしゅーず	じょぎんぐしゅーず 👟
しゅつにゅうこく	しゅつにゅうこく 🛂
あせあせ	あせあせ 💦 💦
お祝い	お祝い ㊗️ 🎀 🎁 🎂 🎉 🎊 🎍 🎎 🎏 🎖️ 🎗️ 🥮 🥳 🪅
高速列車	高速列車 🚄 🚅
ＡＢＣ	ＡＢＣ 🔤
はーとにや	はーとにや 💘
ショッキング	ショッキング 😱
フルール・ド・リス	フルール・ド・リス ⚜️
消火	消火 🧯
ゆうれい	ゆうれい 👻
クリスマス	クリスマス 🎄 🎅 🤶 🧑‍🎄
乗り物	乗り物 ⛴️ ⛵️ ✈️ 🏍️ 🏎️ 🚀 🚁 🚂 🚃 🚄 🚅 🚆 🚇️ 🚈 🚉 🚊 🚋 🚌 🚍️ 🚎 🚏 🚐 🚑️ 🚒 🚓 🚔️ 🚕 🚖 🚗 🚘️ 🚙 🚚 🚛 🚜 🚝 🚞 🚟 🚠 🚡 🚢 🚤 🚲️ 🛥️ 🛩️ 🛫 🛬 🛳️ 🛶 🛸 🛻
おどろき	おどろき 😦 😧 😮 😯 😱 😲 😳 🤨 🤯 🫢
3じ30ふん	3じ30ふん 🕞️
1位	1位 🥇
スパゲッティ	スパゲッティ 🍝
ハート形の手	ハート形の手 🫶
とけらう	とけらう 🇹🇰
おやゆび	おやゆび 👍️
ダンス	ダンス 💃 🕺 🦶 🩰 🪇 🪩
恋文	恋文 💌
肝を冷やした	肝を冷やした 😓
立てた中指	立てた中指 🖕
モザンビーク	モザンビーク 🇲🇿
漬け物	漬け物 🥒
スピーカ	スピーカ 📣
げじげじ	げじげじ 🐛 🐛
ひんずーきょう	ひんずーきょう 🕉️ 🛕
けってい	けってい 🫏
すまいりー	すまいりー ☺️
暑い顔	暑い顔 🥵
はげ頭	はげ頭 👨‍🦲 👩‍🦲 🦲 🧑‍🦲
あなぐま	あなぐま 🦡
ロシア国旗	ロシア国旗 🇷🇺
さっくす	さっくす 🎷
リュックサック	リュックサック 🎒
ZZZ（眠り）	ZZZ（眠り） 💤
しーでぃー	しーでぃー 💿️ 📀
のぼる	のぼる 🧗 🪜
空想	空想 💭
金袋	金袋 💰️
おわかれ	おわかれ 🫂
道化師	道化師 🤡
よがのぽーずをするひと	よがのぽーずをするひと 🧘
しょぼーん	しょぼーん 😔 😔
銅メダル	銅メダル 🥉
freeまーく	freeまーく 🆓
デベロッパ	デベロッパ 👨‍💻 👩‍💻
こもじ	こもじ 🔡
雪山	雪山 🏔️
つきみ	つきみ 🎑
えいせいあんてな	えいせいあんてな 📡
そふとぼーる	そふとぼーる 🥎
目撃	目撃 👁️‍🗨️
ぐらすでかんぱい	ぐらすでかんぱい 🥂
てんもんがく	てんもんがく ⭐️
こもろ	こもろ 🇰🇲
病原菌	病原菌 🪰
ひかりでぃすく	ひかりでぃすく 💿️
とじたじょうとかぎ	とじたじょうとかぎ 🔐
弦楽器	弦楽器 🪉 🪕
競技	競技 🚵
洋ナシ	洋ナシ 🍐
ゴルフをする女	ゴルフをする女 🏌️‍♀️
きんぱつのひと	きんぱつのひと 👱
吸引カップ	吸引カップ 🪠
インフォメーションシンボル	インフォメーションシンボル ℹ️
子午線	子午線 🌐
せき	せき 💺
みらー	みらー 🪞
かきごおり	かきごおり 🍧
えんたーていなー	えんたーていなー 👨‍🎤 👩‍🎤
新幹線（新型）	新幹線（新型） 🚄
ラジオボタン	ラジオボタン 🔘
さんどいっち	さんどいっち 🥪
フェンシングをする人	フェンシングをする人 🤺
ゴシップ	ゴシップ 💁
きせい	きせい ⛔️ 🚫 🚳 🚷
ぴえろ	ぴえろ 🤡
ビデオカメラ	ビデオカメラ 🎥 📹️
心拍	心拍 🫀
みにくいあひるのこ	みにくいあひるのこ 🦢
ぴえん	ぴえん 🥺
サルの顔	サルの顔 🐵
講師	講師 👨‍🏫 👩‍🏫 🧑‍🏫
バルカンサイン	バルカンサイン 🖖
湯飲み	湯飲み 🍵
黒猫	黒猫 🐈‍⬛
高速下ボタン	高速下ボタン ⏬️
びせいぶつ	びせいぶつ 🦠
てのこううえゆびさし	てのこううえゆびさし 👆️
たわー	たわー 🗼
ぶりーふ	ぶりーふ 🩲
ゆきだるま	ゆきだるま ☃️ ⛄️ ⛄️
ばんぱいあ	ばんぱいあ 🦇 🧛 🧛‍♀️ 🧛‍♂️
らぶほ	らぶほ 🏩
禁マーク	禁マーク 🈲
せんこうはなび	せんこうはなび 🎇
ばすけっとぼーるをするおとこ	ばすけっとぼーるをするおとこ ⛹️‍♂️
とろーる	とろーる 🧌
卒業式	卒業式 🎓️
きつねのかお	きつねのかお 🦊
ハート（トランプ）	ハート（トランプ） ♥️
べんとう	べんとう 🍱 🥡
コンビニエンスストア	コンビニエンスストア 🏪
機関車	機関車 🚂
ふじさん	ふじさん 🗻
えいぎょうび	えいぎょうび 🈺
やまのぼり	やまのぼり 🧗 🧗‍♀️ 🧗‍♂️
くちべに	くちべに 💄
もえる	もえる 🔥
断る	断る 🫷 🫸
サーカス小屋	サーカス小屋 🎪
スタジアム	スタジアム 🏟️
にんじゅつ	にんじゅつ 🥷
しはらい	しはらい 💳️ 💸
すけじゅーる	すけじゅーる 📅 📆 🗓️
くずかご	くずかご 🗑️ 🗑️ 🚮 🚮
dna	dna 🧬
タキシードの男性	タキシードの男性 🤵‍♂️
あぶく	あぶく 🫧 🫧
ボリビア	ボリビア 🇧🇴
りっぷ	りっぷ 💄
ジャグリング	ジャグリング 🤹 🤹‍♀️ 🤹‍♂️
喫煙	喫煙 🚬
あかいしたさんかく	あかいしたさんかく 🔻
ガーリック	ガーリック 🧄
かふぇいん	かふぇいん ☕️
空手	空手 🥋
国旗（中国）	国旗（中国） 🇨🇳
おやゆびとひとさしゆびをくろす	おやゆびとひとさしゆびをくろす 🫰
側転	側転 🤸 🤸‍♀️ 🤸‍♂️
てをつなぐじょせい	てをつなぐじょせい 👭
まうんてんばいくにのるひと	まうんてんばいくにのるひと 🚵
ぱいろっと	ぱいろっと 👨‍✈️ 🧑‍✈️
きねんび	きねんび 👨‍❤️‍👨 👨‍❤️‍💋‍👨 👩‍❤️‍👨 👩‍❤️‍👩 👩‍❤️‍💋‍👨 👩‍❤️‍💋‍👩 💏 💑 💕 💝
ぶらじる	ぶらじる 🇧🇷
星座	星座 ♈️ ♉️ ♊️ ♋️ ♌️ ♍️ ♎️ ♏️ ♐️ ♑️ ♒️ ♓️ ⚖️ ⛎️ 🏹 🏺 🐂 🐍 🐏 🐐 🐟️ 🦀 🦁 🦂
かいもの	かいもの 🛒
えすかるご	えすかるご 🐌
保育所	保育所 📛
ウェールズ	ウェールズ 🏴󠁧󠁢󠁷󠁬󠁳󠁿
うけるね	うけるね 😆 😆 🤣 🤣
まつばづえ	まつばづえ 🩼
エストニア	エストニア 🇪🇪
イーグル	イーグル 🦅
万年筆	万年筆 ✒️ 🖋️
ごくひ	ごくひ ㊙️
四つ葉のクローバー	四つ葉のクローバー 🍀
もみじ	もみじ 🍁 🍁
牡羊座	牡羊座 ♈️
レスラー	レスラー 🤼
なきがお	なきがお 😢 😩 🥹
どうけし	どうけし 🤡
げいじゅつか	げいじゅつか 👨‍🎨 👩‍🎨 🧑‍🎨
おどりこ	おどりこ 💃
ぶるねい	ぶるねい 🇧🇳
あふりか	あふりか 🌍️
そり競技	そり競技 🛷
うわむき	うわむき 📈
ポーカーフェイス	ポーカーフェイス 😐️
ボクシンググローブ	ボクシンググローブ 🥊
ゔぃらん	ゔぃらん 🦹 🦹‍♀️ 🦹‍♂️
こすたりか	こすたりか 🇨🇷
こんごきょうわこく(ぶらざびる)	こんごきょうわこく(ぶらざびる) 🇨🇬
ココ	ココ 🈁
コブ	コブ 🐪 🐫
ピザ	ピザ 🍕
墓石	墓石 🪦
にっこりわらうねこ	にっこりわらうねこ 😺
生姜	生姜 🫚
パプリカ	パプリカ 🫑
韓国	韓国 🇰🇷
案内する女	案内する女 💁 💁‍♀️
がっこう、ようちえん、ほいくしょとうあり	がっこう、ようちえん、ほいくしょとうあり 🚸
営マーク	営マーク 🈺
こがたばす	こがたばす 🚐
めきしかん	めきしかん 🌮 🌯 🫔
浮いてるビジネスマン	浮いてるビジネスマン 🕴️
きちょう	きちょう 🧑‍✈️
やきがし	やきがし 🧇
かわぐつ	かわぐつ 👞
せくしー	せくしー 💋 🫦
レンチ	レンチ 🔧 🛠️
しょうかき	しょうかき 🧯
ピン	ピン 📍
くもりいちじはれ	くもりいちじはれ 🌥️
しょしんしゃまーく	しょしんしゃまーく 🔰
ぱいん	ぱいん 🍍
あわぶろ	あわぶろ 🛁
回り矢印１	回り矢印１ ↪️
回り矢印２	回り矢印２ ↩️
結婚式	結婚式 💒
すのーぼーど	すのーぼーど 🏂️
でべろっぱ	でべろっぱ 👨‍💻 👩‍💻
アライグマ	アライグマ 🦝
赤身肉	赤身肉 🥩
そりきょうぎ	そりきょうぎ 🛷
中国	中国 🇨🇳
法輪	法輪 ☸️
青い本	青い本 📘
カット	カット ✂️ 💇 💇‍♂️
ボディビル	ボディビル 💪
歩行者立入禁止	歩行者立入禁止 🚷
しかめ面の人	しかめ面の人 🙍
はてな	はてな ❓️ ❔️
がりべん	がりべん 🤓
てにすぼーる	てにすぼーる 🎾
でんどうくるまいすのだんせい	でんどうくるまいすのだんせい 👨‍🦼 👨‍🦼‍➡️
りとあにあ	りとあにあ 🇱🇹
べるぎー	べるぎー 🇧🇪
クウェート	クウェート 🇰🇼
とびら	とびら 🚪
とおかやのつき	とおかやのつき 🌔
しょうかん	しょうかん 🧙
じじ	じじ 🃏
カップ	カップ ☕️
らっぷとっぷ	らっぷとっぷ 💻️
コピー機	コピー機 🖨️
おしろ	おしろ 🏯 🏰
へんそう	へんそう 🥸
だんせいとじょせいとおんなのことおとこのこのかぞく	だんせいとじょせいとおんなのことおとこのこのかぞく 👨‍👩‍👧‍👦
ほしぞら	ほしぞら 🌃 🌌
ふぁいるきゃびねっと	ふぁいるきゃびねっと 🗄️
すくろーる	すくろーる 📜
まほうのつえ	まほうのつえ 🪄
黄色のハート	黄色のハート 💛
じつ	じつ 🫒
ろぶすたー	ろぶすたー 🦞
しゅーず	しゅーず 👟 🩰
チュー２	チュー２ 😚
スペイン	スペイン 🇪🇸
じょゆう	じょゆう 🎭️
営業中	営業中 🈺
うえむき	うえむき 📈
小麦	小麦 🍞
お知らせ（メガホン）	お知らせ（メガホン） 📢
しかめつらのひと	しかめつらのひと 🙍
かいか	かいか 🌷 🌸 🌼
かいが	かいが 🎨 🖼️
タンブラー	タンブラー 🥃
倍速	倍速 ⏩️ ⏪️
飛ぶ	飛ぶ 🪶 🪽
右に向けた手	右に向けた手 🫱
れすりんぐするおんな	れすりんぐするおんな 🤼‍♀️
7時	7時 🕖️
ぼーとをこぐひと	ぼーとをこぐひと 🚣
シーク教徒	シーク教徒 🪯
裁判	裁判 👨‍⚖️ 👩‍⚖️ 🧑‍⚖️
ひやあせあおざめ	ひやあせあおざめ 😰
バルカンの挨拶	バルカンの挨拶 🖖
ゆにこーん	ゆにこーん 🦄
くうせき	くうせき 🈳
ＳＯＳ	ＳＯＳ 🆘
てんびん	てんびん ⚖️
バレエ	バレエ 🩰
ふぇいすまっさーじちゅうのおんな	ふぇいすまっさーじちゅうのおんな 💆‍♀️
かいと	かいと 🪁
100	100 💯 💯
えいぎょう	えいぎょう 🈺
整備士	整備士 🧑‍🔧 🧰
はーとのえがお	はーとのえがお 🥰
かいわ	かいわ 💬 🗨️
天秤座	天秤座 ♎️ ⚖️
れしーと	れしーと 🧾
宗教	宗教 ☦️ ☪️ ☯️ ☸️ ⛩️ ⛪️ ✝️ ✡️ 📿 🕉️ 🕋 🕌 🕍 🕎 🛐 🛕 🪯
むせきついどうぶつ	むせきついどうぶつ 🪼
かとらりー	かとらりー 🍴 🥄
ショッピング	ショッピング 👜 🛒
割（割引）	割（割引） 🈹
ハンバーガー	ハンバーガー 🍔
こういん	こういん 👨‍🏭 👩‍🏭 🧑‍🏭
空室	空室 🈳
せんさくずき	せんさくずき 🦝
牛乳	牛乳 🥛
右矢印	右矢印 ➡️
すばーるばるしょとう・やんまいえんとう	すばーるばるしょとう・やんまいえんとう 🇸🇯
かいぞく	かいぞく 🏴‍☠️ 🦜
スペード	スペード ♠️
パラシュート	パラシュート 🪂
たきしーどのだんせい	たきしーどのだんせい 🤵‍♂️
dvd	dvd 💿️ 📀
はりうっど	はりうっど 🎥
あかいばら	あかいばら 🌹
落胆	落胆 🫥
踊り子	踊り子 💃
開いたフォルダー	開いたフォルダー 📂
平和のシンボル	平和のシンボル ☮️
じゅうりょうあげをするひと	じゅうりょうあげをするひと 🏋️
ひらく	ひらく 📂
バレー	バレー 🏐
ぱちぱち	ぱちぱち 👏
ハンマー	ハンマー ⚒️ 👷 👷‍♀️ 👷‍♂️ 🔨
りんぐない	りんぐない 🤼 🤼‍♀️ 🤼‍♂️
化け物	化け物 👹
ライフセーバー	ライフセーバー 🛟
まじっく	まじっく 🪄
ローラースケート	ローラースケート 🛼
てんたいかんそく	てんたいかんそく 🔭
まいくろばす	まいくろばす 🚐
無限大	無限大 ♾️
涙ぽろり（ネコ）	涙ぽろり（ネコ） 😿
みゃく	みゃく 🫀
大災害	大災害 🧟
バチカン市国	バチカン市国 🇻🇦
はりけーん	はりけーん 🌀
ひとり	ひとり 👤
花丸	花丸 💮
カブトムシ	カブトムシ 🪲
○	○ ⭕️
撮影	撮影 🎥
ゆのみ	ゆのみ 🍵
あかいんげんまめ	あかいんげんまめ 🫘
開いた	開いた 📬️ 📭️
キャラクター（万歳）	キャラクター（万歳） 🙌
自分撮り	自分撮り 🤳
忍び	忍び 🥷
方位磁針	方位磁針 🧭
遺伝子	遺伝子 🧬
ワイングラス	ワイングラス 🍷
味見	味見 😝
右肩上がり	右肩上がり 📈
９じ	９じ 🕘️
アルゼンチン	アルゼンチン 🇦🇷
だんせいとじょせいとおんなのことおんなのこのかぞく	だんせいとじょせいとおんなのことおんなのこのかぞく 👨‍👩‍👧‍👧
パイ	パイ 🥧
やくそう	やくそう 🌿 🫚
やじるしさゆう	やじるしさゆう ↔️
topやじるし	topやじるし 🔝
ほほをあからめる	ほほをあからめる 😊
のぶた	のぶた 🐗
目がハートの笑顔	目がハートの笑顔 😍
コスメ	コスメ 💄
ぴとけあんしょとう	ぴとけあんしょとう 🇵🇳
出入国審査	出入国審査 🛂
飲み物	飲み物 ☕️ 🍵 🍾 🧃 🧉 🧋 🫖 🫗
左上矢印	左上矢印 ↖️
スパークリングワイン	スパークリングワイン 🍾 🥂
パパ	パパ 👨‍🍼
エレベーター	エレベーター 🛗
びっくりマーク	びっくりマーク ‼️ ⁉️ ❕️ ❗️ ❣️
ワッフル	ワッフル 🧇
先生	先生 👨‍🏫 👩‍🏫 🧑‍🏫
ごきぶり	ごきぶり 🪳
exclamation	exclamation ❗️
でんでんむし	でんでんむし 🐌
バッファロー	バッファロー 🐃 🦬
ヘッドホン	ヘッドホン 🎧️
のうかのだんせい	のうかのだんせい 👨‍🌾
マイホーム	マイホーム 🏠️ 🏡
なんたいどうぶつ	なんたいどうぶつ 🐙 🦑
しんまーく	しんまーく 🈸
ピクニック	ピクニック 🧺
がらす	がらす 🫗
まじゅつし	まじゅつし 🧙 🪄
バスタブ	バスタブ 🛀 🛁
まぐねっと	まぐねっと 🧲
パン	パン 🍞 🥐 🥖 🥨 🥪 🥯 🫓
すぱーくりんぐわいん	すぱーくりんぐわいん 🍾 🥂
8:00	8:00 🕗️ 🕗️
めがほん	めがほん 📢 📣
観測	観測 🔭
ヨーロッパ	ヨーロッパ 🌍️
ひまわり	ひまわり 🌻 🌻
いなずま	いなずま ⚡️ ⚡️ ⛈️ 🌩️
パー	パー ✋️ 🖐️
グー	グー ✊️ 👊
にじぇーる	にじぇーる 🇳🇪
おおわらい	おおわらい 😂
トウモロコシ	トウモロコシ 🌽
おわん帽の人	おわん帽の人 👲
さい	さい 🦏
食べ過ぎ	食べ過ぎ 🫃 🫄
らばし	らばし 🫓
ふっとぼーる	ふっとぼーる 🏈
下着	下着 🩲 🩳
仮装	仮装 🥸
吐きそう	吐きそう 🤢
宝物	宝物 🏴‍☠️
裁判官	裁判官 👨‍⚖️ 👩‍⚖️ 🧑‍⚖️
救命浮環	救命浮環 🛟
失敗	失敗 😣
鉄道	鉄道 🚂 🚃 🚄 🚅 🚈 🛤️
時計（９時）	時計（９時） 🕘️
人工装具	人工装具 🦾 🦿
さんまるたん	さんまるたん 🇲🇫
さけ	さけ 🍶
月２（顔つき）	月２（顔つき） 🌛
はっぱ	はっぱ 🌿 🍁 🍂 🍃
へっどふぉん	へっどふぉん 🎧️
らんぷをこする	らんぷをこする 🧞
ばーすでーけーき	ばーすでーけーき 🎂
ぴあの	ぴあの 🎹
さす	さす 🦟 🪼
送信トレイ	送信トレイ 📤️
もあい	もあい 🗿
ノートパソコン	ノートパソコン 💻️
ふりー	ふりー 🆓
おんなのこ	おんなのこ 👧 👨‍👧 👨‍👧‍👦 👨‍👧‍👧 👨‍👨‍👧 👨‍👨‍👧‍👦 👨‍👨‍👧‍👧 👨‍👩‍👧 👨‍👩‍👧‍👦 👨‍👩‍👧‍👧 👩‍👧 👩‍👧‍👦 👩‍👧‍👧 👩‍👩‍👧 👩‍👩‍👧‍👦 👩‍👩‍👧‍👧
金貨	金貨 🪙
さめ	さめ 🦈
にっこう	にっこう ☀️ 🌅
さや	さや 🫛 🫛
うれしい	うれしい 😆
ちゃいろのまる	ちゃいろのまる 🟤
さら	さら 🍽️
ふみつける	ふみつける 🦶
さる	さる 🐒 🐒 🐵 🐵 🙈 🙉 🙊 🦧
さばく	さばく 🌵 🏜️ 🐪 🐫
がそりん	がそりん ⛽️
4時	4時 🕓️
割る	割る ➗️
包帯	包帯 ❤️‍🩹 🤕
リボン	リボン 🎀 🎁 🎗️ 💝
がまぐち	がまぐち 👛
大人一人と子供二人の家族	大人一人と子供二人の家族 🧑‍🧒‍🧒
おてあらい	おてあらい 🚹️ 🚺️ 🚻 🚽 🚾
りっぷすてぃっく	りっぷすてぃっく 💄
つまむ	つまむ 👌 👌
くちびる	くちびる 👄 💋 💋 🫦
歴史的建造物	歴史的建造物 🏛️
でーた	でーた 📈 📉 📊
にっこり	にっこり 😀 😀
ゆびさし	ゆびさし ☝️ 👆️ 👇️ 👈️ 👉️ 🖕 🫵
りらっくす	りらっくす 💆 💆‍♂️ 🧖 🧘
ゆびさす	ゆびさす 👆️ 👇️ 👈️ 👉️
ひたいにて	ひたいにて 🤦 🤦‍♀️ 🤦‍♂️
ほんじゅらす	ほんじゅらす 🇭🇳
空（空室）	空（空室） 🈳
がそりんすたんど	がそりんすたんど ⛽️
でんきこう	でんきこう 👨‍🔧 👩‍🔧
でーと	でーと 💕 😗 😚
ねんぱい	ねんぱい 🦳
クラゲ	クラゲ 🪼
クラブ	クラブ ♣️ 🍸️
ひだりがわ	ひだりがわ 🫲
8:30	8:30 🕣️ 🕣️
ぐあてまら	ぐあてまら 🇬🇹
左向きのこぶし	左向きのこぶし 🤛
しかめ面の女	しかめ面の女 🙍‍♀️
LGBTQ	LGBTQ 🌈 🌈 🏳️‍🌈 🏳️‍🌈
検閲	検閲 🤬
つまみ	つまみ 🎛️ 🎛️
べるぼーいべる	べるぼーいべる 🛎️
的中	的中 🎯
ぷろぐらまー	ぷろぐらまー 👨‍💻 👩‍💻
微笑む	微笑む 🙂
かめらふらっしゅ	かめらふらっしゅ 📸
とべないとり	とべないとり 🦤
ういるす	ういるす 🦟 🦠
むすりむ	むすりむ ☪️
ハグする人	ハグする人 🫂
にやっとわらう	にやっとわらう 😁
つながったクリップ	つながったクリップ 🖇️
きごうのにゅうりょく	きごうのにゅうりょく 🔣
右指差し	右指差し 👉️
ぎんこう	ぎんこう 🏦 🏧 💰️ 💳️
赤インゲン豆	赤インゲン豆 🫘
げんがっき	げんがっき 🪉 🪕
眉を上げた顔	眉を上げた顔 🤨
うけつけ	うけつけ 💁
歌記号	歌記号 〽️
そまりあ	そまりあ 🇸🇴
たつおんな	たつおんな 🧍‍♀️
にくだんご	にくだんご 🧆
しかめ面	しかめ面 ☹️ 😕 😦 😬 🙁
ひづけ	ひづけ 📅 📆 🗓️
しらはた	しらはた 🏳️
ジョッキー	ジョッキー 🏇
おだいりさま	おだいりさま 🎎
賞杯	賞杯 🏆️
ごーる	ごーる 🥅 🥍
麻雀牌	麻雀牌 🀄️
うえかーぶやじるし	うえかーぶやじるし ⤴️
微笑み	微笑み 😊 🙂
クリスマス島	クリスマス島 🇨🇽
じょせいぎじゅつしゃ	じょせいぎじゅつしゃ 👩‍💻
くるり	くるり ➰️
まるいしんかんせん	まるいしんかんせん 🚅
聞こえない	聞こえない 🧏
はれときどきくもり	はれときどきくもり 🌤️
アールブイ車	アールブイ車 🚙
別れた	別れた 💔
ハンドバック	ハンドバック 👜
ハンドバッグ	ハンドバッグ 👜 👝
まーじゃんぱい	まーじゃんぱい 🀄️
くるま	くるま 🏎️ 🚌 🚍️ 🚐 🚑️ 🚒 🚕 🚖 🚗 🚘️ 🚙 🚚 🚛 🚜 🛞 🛻
分かった	分かった 🙋
地下鉄	地下鉄 Ⓜ️ 🚇️
モーリタニア	モーリタニア 🇲🇷
にんぎょう	にんぎょう 🎎 🪅 🪆
ふぁすとふーど	ふぁすとふーど 🍔 🍟
めいそう	めいそう 🧘 🧘‍♀️ 🧘‍♂️
フタコブ	フタコブ 🐫
すまーとふぉん	すまーとふぉん 📱 📲 📳 📴 📶
ほうしゃのう	ほうしゃのう ☢️
交差点	交差点 🚥 🚦
６じ	６じ 🕕️
おんなのぞんび	おんなのぞんび 🧟‍♀️
ドル札	ドル札 💵
たぴおか	たぴおか 🧋
表情（あくび）	表情（あくび） 😪
病気	病気 💉 💊 😵 😷 🤒 🤢 🤮 🦟 🩺
しおり	しおり 🔖 🔖
12時30分	12時30分 🕧️
ろまんす	ろまんす 💒
てじな	てじな 🪄
きょうそうば	きょうそうば 🏇 🐎
閉じた錠	閉じた錠 🔒️
ピンクのハート	ピンクのハート 🩷
あうたー	あうたー 🧥
ぴんくのはーと	ぴんくのはーと 🩷
空席	空席 🈳
べとなむ	べとなむ 🇻🇳
ノコ	ノコ 🪚
顔２（おこったカオ）	顔２（おこったカオ） 😠
ノブ	ノブ 🎛️
う	う 🐰
1時30分	1時30分 🕜️
ロールペーパー	ロールペーパー 🧻
あかちゃん	あかちゃん 🍼 👨‍🍼 👩‍🍼 👶 👶 🚼️ 🤱 🧑‍🍼
え	え 🎨 🖼️
キス	キス 👄 👨‍❤️‍💋‍👨 👩‍❤️‍💋‍👨 👩‍❤️‍💋‍👩 💋 💏 😗 😘 😙 😚 😽
か	か 🉑 🦟
き	き 🌲 🌳 🌴 🪓 🪵
親機	親機 ☎️
車（セダン）	車（セダン） 🚗
高所作業	高所作業 🪜
しゃりん	しゃりん 🛞
VSマーク	VSマーク 🆚
掃く	掃く 🧹
やしの木	やしの木 🌴
さ	さ 🈂️
スマホ	スマホ 📱 📲 📳 📴 📶 🛜 🤳
し	し ☠️ ⚰️ ⚱️ 💀
おわん帽	おわん帽 👲
す	す 🪹 🪺
おとこのせいれい	おとこのせいれい 🧞‍♂️
男性パイロット	男性パイロット 👨‍✈️
けいたいきんし	けいたいきんし 📵
表情（大泣き）	表情（大泣き） 😭
女性と女性と女の子と男の子の家族	女性と女性と女の子と男の子の家族 👩‍👩‍👧‍👦
ぎゃくまわり	ぎゃくまわり 🔄
押しピン	押しピン 📌 📍
飲み水	飲み水 🚰
む	む 🈚️
め	め 🌱 👀 👁️ 👁️‍🗨️ 👨‍🦯 👨‍🦯‍➡️ 👩‍🦯 👩‍🦯‍➡️ 🧑‍🦯 🧑‍🦯‍➡️ 🪬
ち	ち 🧛
や	や 🏹 💘
5:00	5:00 🕔️ 🕔️
ぱにっく	ぱにっく 🫨
て	て ☝️ ✊️ ✋️ ✌️ ✍️ 👆️ 👇️ 👈️ 👉️ 👊 👋 👌 👍️ 👎️ 👏 👐 🖐️ 🖕 🖖 🙆 🙋 🙌 🙏 🤌 🤏 🤘 🤙 🤚 🤛 🤜 🤝 🤞 🤟 🤲 🦾 🧑‍🤝‍🧑 🧤 🪬 🫰 🫱 🫲 🫳 🫴 🫵 🫶 🫷 🫸
はだし	はだし 👣
ひめくり	ひめくり 📆
中指	中指 🖕
開いた郵便受け	開いた郵便受け 📬️ 📭️
と	と 🚪
ぶるずあい	ぶるずあい 🎯
ねがお	ねがお 😴
小型機	小型機 🛩️
キー	キー 🔐 🔑 🗝️
しかめ顔	しかめ顔 😦 😬 🙍 🙍‍♀️ 🙍‍♂️
ね	ね 🐭
わ	わ ⭕️ 🎋 🎍 🎎
せんきょ	せんきょ 🗳️
は	は ☘️ 🌿 🍀 🍁 🍂 🍃 🦷 🧛 🪒 🪚
げい	げい 🌈 🏳️‍🌈
表情（ほっ）	表情（ほっ） 😌
失望	失望 🙍
ひ	ひ ㊙️ 🔥
デパート	デパート 🏬
けいと	けいと 🧶
シェイブアイス	シェイブアイス 🍧
試合	試合 🥌
棒付きキャンディ	棒付きキャンディ 🍭
つきぎめ	つきぎめ 🈷️
きょうじゅ	きょうじゅ 👨‍🏫 👩‍🏫 🧑‍🏫
ボウルとスプーン	ボウルとスプーン 🥣
ぱれっと	ぱれっと 🎨 👩‍🎨
けいば	けいば 🏇 🐎
み	み 🫒
くっきー	くっきー 🍪
けいび	けいび 💂 💂‍♀️ 💂‍♂️
かくせいき	かくせいき 📢 📣
2人でキス	2人でキス 👨‍❤️‍💋‍👨 👩‍❤️‍💋‍👨 👩‍❤️‍💋‍👩 💏
血液型A型	血液型A型 🅰️
ぷらかーど	ぷらかーど 🪧
情け	情け 🥺
おらんだ	おらんだ 🇳🇱
ディスカウント	ディスカウント 🈹
おーとばい	おーとばい 🏍️ 🛵
そっくす	そっくす 🧦
約物	約物 ‼️ ✳️ ✴️ ❇️ ❓️ ❔️ ❕️ ❗️ 〰️ 〽️
囲み数字	囲み数字 #️⃣ *️⃣ 0️⃣ 1️⃣ 2️⃣ 3️⃣ 4️⃣ 5️⃣ 6️⃣ 7️⃣ 8️⃣ 9️⃣ 🔟
サ	サ 🈂️ 🈂️
臭い	臭い 💩
はんどぼーるをするおとこ	はんどぼーるをするおとこ 🤾‍♂️
くちばし	くちばし 🐦‍⬛ 🐦‍⬛
げろ	げろ 🤮 🤮
着信中	着信中 📲
1時	1時 🕐️
そっくり	そっくり 👯 👯
規制	規制 ⛔️ 🚫 🚳 🚷
吹き出し	吹き出し 👁️‍🗨️ 💬 💭 🗨️ 🗯️
アレパ	アレパ 🫓
きゅうしゅう	きゅうしゅう 🧽
みせいねん	みせいねん 🔞
ようき	ようき 🪣 🫙
りずむ	りずむ 🪇 🪘
月（月額）	月（月額） 🈷️
女性と女性と女の子と女の子の家族	女性と女性と女の子と女の子の家族 👩‍👩‍👧‍👧
マイナス	マイナス ➖️
人工衛星	人工衛星 🛰️
・	・ ➗️
ー	ー ➖️ 〰️
ポーランド	ポーランド 🇵🇱
5:30	5:30 🕠️ 🕠️
しょうぼう	しょうぼう 🧯
受信ＢＯＸ	受信ＢＯＸ 📥️
ピッコロ	ピッコロ 🪈
きりり（ネコ）	きりり（ネコ） 😼
太い丸	太い丸 ⭕️
だんせいとだんせいとおんなのことおとこのこのかぞく	だんせいとだんせいとおんなのことおとこのこのかぞく 👨‍👨‍👧‍👦
おおきいおれんじのひしがた	おおきいおれんじのひしがた 🔶
料理（たまご）	料理（たまご） 🍳
お願い	お願い 🙇 🙏 🥺
ごうい	ごうい 🤝
防具	防具 🛡️
結婚	結婚 👰 💒 🤵
夢中	夢中 😶‍🌫️ 🥰
すたー	すたー ✨️ ⭐️ 🌟 🌠 👨‍🎤 👩‍🎤 🧑‍🎤
しょうかきぐ	しょうかきぐ 🧯
まくのうち	まくのうち 🍱
だんせいとおとこのこのかぞく	だんせいとおとこのこのかぞく 👨‍👦
セルフィー	セルフィー 🤳
スケルトン	スケルトン 🛷
エイトボール	エイトボール 🎱
月マーク	月マーク 🈷️
ロックオン	ロックオン 🤘
火事	火事 🧯
パトロール	パトロール 🚓
セントルシア	セントルシア 🇱🇨
じょしといれ	じょしといれ 🚺️
7じはん	7じはん 🕢️
化学療法	化学療法 🦲
輝度	輝度 🔅 🔆
家具	家具 🪑
六芒星	六芒星 ✡️ 🔯
気温	気温 🌡️
U字型磁石	U字型磁石 🧲
きんえん	きんえん 🚭️
宅配便	宅配便 📦️
ハード島・マクドナルド諸島	ハード島・マクドナルド諸島 🇭🇲
太鼓	太鼓 🥁 🪘
おれんじのまる	おれんじのまる 🟠
解錠	解錠 🔓️
考え中	考え中 🤔
フォンデュ	フォンデュ 🫕
ばれえしゅーず	ばれえしゅーず 🥿 🩰
踏みつける	踏みつける 🦶
すぱーくる	すぱーくる ❇️
かふぇ	かふぇ ☕️
ふっく	ふっく 🪝
紙袋	紙袋 🛍️
あおりんご	あおりんご 🍏
化粧品	化粧品 💄
コロッケ	コロッケ 🧆
しょっぱい	しょっぱい 🧂 🧂
揺れるハート	揺れるハート 💓
女性のサンタ	女性のサンタ 🤶
活動的	活動的 🤸
はいうぇい	はいうぇい 🛣️
さいばん	さいばん 👨‍⚖️ 👩‍⚖️ 🧑‍⚖️
だんせいしょうぼうし	だんせいしょうぼうし 👨‍🚒
どくろとほね	どくろとほね ☠️
３じ	３じ 🕒️
考え事	考え事 💭
右矢印１	右矢印１ ➡️
右矢印２	右矢印２ ↗️
ぎにあびさう	ぎにあびさう 🇬🇼
おやすみ	おやすみ 💤 💤 😴 😴 🛌 🛌 🥱 🥱
おんなのまほうつかい	おんなのまほうつかい 🧙‍♀️
はしるおんな	はしるおんな 🏃‍♀️ 🏃‍♀️‍➡️
スピーカー音量大	スピーカー音量大 🔊
8じ	8じ 🕗️
しずかに	しずかに 🤫 🫢
ぽーらんど	ぽーらんど 🇵🇱
むげんだい	むげんだい ♾️
リボルバー	リボルバー 🔫
丸いMマーク	丸いMマーク Ⓜ️
しぇふ	しぇふ 👨‍🍳 👩‍🍳 🧑‍🍳
ぴすとる	ぴすとる 🔫
クロアチア	クロアチア 🇭🇷
とじたじょう	とじたじょう 🔒️
オフ	オフ 📴
スパイダー	スパイダー 🕷️ 🕸️
ラテン十字	ラテン十字 ✝️
こうふん	こうふん 🤸 🤸‍♀️ 🤸‍♂️
まにあ	まにあ 🤓
やくしゃ	やくしゃ 🎭️
したゆびさし	したゆびさし 👇️
はんまーとつるはし	はんまーとつるはし ⚒️
１２じ	１２じ 🕛️
ふれーむ	ふれーむ 🎞️ 🪟
かがくしゃ	かがくしゃ 👨‍🔬 👩‍🔬 🥼 🧑‍🔬 🧪
ゴール	ゴール 🥅 🥍
まゆをあげたかお	まゆをあげたかお 🤨
逃げる	逃げる 💨
そうしん	そうしん 📤️ 📩
エスカルゴ	エスカルゴ 🐌
バスケットボール選手	バスケットボール選手 ⛹️
オン	オン 🔛
2:00	2:00 🕑️ 🕑️
くちがななめのかお	くちがななめのかお 🫤
だめのぽーずをするひと	だめのぽーずをするひと 🙅
パソコン	パソコン ⌨️ 👨‍💻 👩‍💻 💻️ 🖥️ 🖱️ 🖲️ 🧑‍💻
オートバイ	オートバイ 🏍️ 🛵
マンモス	マンモス 🦣
サラダ	サラダ 🥗 🥬
きいろいはーと	きいろいはーと 💛
食べ物	食べ物 🥭 🫐 🫑 🫒 🫓 🫔 🫕 🫘
とるこ	とるこ 🇹🇷
じゃーじー	じゃーじー 🇯🇪
キノコ	キノコ 🍄 🍄‍🟫
こんごみんしゅきょうわこく(きんしゃさ)	こんごみんしゅきょうわこく(きんしゃさ) 🇨🇩
団扇	団扇 🪭
くう	くう 🈳
1にん	1にん 👤
れすりんぐたいかい	れすりんぐたいかい 🤼 🤼‍♀️ 🤼‍♂️
くれじっとかーど	くれじっとかーど 💳️
ぎゅうにゅういりのこっぷ	ぎゅうにゅういりのこっぷ 🥛
ぽるとがる	ぽるとがる 🇵🇹
はんまー	はんまー ⚒️ 👷 👷‍♀️ 👷‍♂️ 🔨
しまい	しまい 👭
したかーぶやじるし	したかーぶやじるし ⤵️
ピエロの顔	ピエロの顔 🤡
ブラシ	ブラシ 🪥
くさ	くさ ☘️ 🌾 🌿 🍀
くし	くし 🍡 🍢 🪮 🪮
くじ	くじ 🕘️
枯れ葉	枯れ葉 🍂
動悸	動悸 💓
1曲リピートボタン	1曲リピートボタン 🔂
じゃけっと	じゃけっと 🧥
射手	射手 🏹
おじぎするおんな	おじぎするおんな 🙇‍♀️
くも	くも ☁️ ⛅️ ⛈️ 🌤️ 🌥️ 🌦️ 🌧️ 🌨️ 🌩️ 🌫️ 🌬️ 💭 🕷️ 🕸️
くち	くち 👄 🤐 🫦
こんごきょうわこく	こんごきょうわこく 🇨🇬
くつ	くつ 👞 👟 👟 👠 👠 👡 👢 🥾 🩰 🩴
うちっぱなし	うちっぱなし 🏌️
くり	くり 🌰 🌰
和菓子	和菓子 🍡
表情（悲しい）	表情（悲しい） 😢
コスタリカ	コスタリカ 🇨🇷
くろ	くろ ▪️ ◼️ ◾️ ⚫️ ⬛️ 🏴 🐈‍⬛ 🐦‍⬛ 🖤
まくどなるどしょとう	まくどなるどしょとう 🇭🇲
ひだりうえ	ひだりうえ ↖️
自転車に乗る人	自転車に乗る人 🚴
さるさ	さるさ 💃 🕺
スレートグレー	スレートグレー 🩶
ろっくかくにん	ろっくかくにん 🔐
座席	座席 💺
有明月	有明月 🌘
リヒテンシュタイン	リヒテンシュタイン 🇱🇮
あそびすき	あそびすき 🦦
ふざけたかお	ふざけたかお 🤪
せきしょくとう	せきしょくとう 🚨
くま	くま 🐻 🐻 🐻‍❄️ 🧸 🧸 🫩
ちゃいろいくつ	ちゃいろいくつ 🥾
メキシカン	メキシカン 🌮 🌯 🫔
ほうりん	ほうりん ☸️
足す	足す ➕️
割れたハート	割れたハート 💔
とざんでんしゃ	とざんでんしゃ 🚞
ぶるーぼねっと	ぶるーぼねっと 🪻
新生児	新生児 🍼 👨‍🍼 👩‍🍼 👶 🧑‍🍼
ぱんだ	ぱんだ 🐼
ぱんち	ぱんち 👊 🤛 🤜
りぼるばー	りぼるばー 🔫
マラリア	マラリア 🦟
ぱんや	ぱんや 🥯
ぱんつ	ぱんつ 👖 🩲 🩳
2:30	2:30 🕝️ 🕝️
れすとらん	れすとらん 🍳 🍴
生物学	生物学 🧫 🧬
あるく	あるく 🚶 🚶‍♀️ 🚶‍♀️‍➡️ 🚶‍➡️
羽のはえたお札	羽のはえたお札 💸
ほごめがね	ほごめがね 🥽
ベリー	ベリー 🫐
操る	操る 🤹 🤹‍♂️
ふぉーまる	ふぉーまる 🤵
やけい	やけい 🌃 🌉
さうなにはいるひと	さうなにはいるひと 🧖
サのまーく	サのまーく 🈂️
頬を赤らめる	頬を赤らめる 😊
目がハートの猫	目がハートの猫 😻
ないす	ないす 😀 😁
表情（ぶんぶん）	表情（ぶんぶん） 😠
トイレマーク	トイレマーク 🚾
少し困った	少し困った 🙁
帆船	帆船 ⛵️
おんりょうだい	おんりょうだい 🔊
めりーごーらんど	めりーごーらんど 🎠
ちゃいろ	ちゃいろ 🟤 🟫 🤎
スイマー	スイマー 🏊️ 🏊‍♀️ 🏊‍♂️
ふきげんなひと	ふきげんなひと 🙎
あるば	あるば 🇦🇼
憂鬱	憂鬱 🫥
こうそくどうろ	こうそくどうろ 🛣️
赤毛の人	赤毛の人 🦰
ペン先	ペン先 ✒️
そふとくりーむ	そふとくりーむ 🍦
聞き耳	聞き耳 👂️
かに座	かに座 ♋️
もるたる	もるたる 🧱
上向きにすぼめた手	上向きにすぼめた手 🤌
ロシア	ロシア 🇷🇺 🪆
しなごーぐ	しなごーぐ 🕍
のんびり	のんびり 🦥 🦥
end	end 🔚 🔚
泣く	泣く 😢 😭 😿 🥲
おひつじ	おひつじ 🐏
海の生物	海の生物 🧜
ないふ	ないふ 🍴 🍽️ 🔪 🗡️
ガーガー	ガーガー 🪿
じゅしんちゅう	じゅしんちゅう 📨
星座（しし座）	星座（しし座） ♌️
おれんじのほん	おれんじのほん 📙
ぞんび	ぞんび 🧟 🧟‍♀️ 🧟‍♂️
爆弾	爆弾 💣️
急ぐ	急ぐ 🏃 🏃‍♀️ 🏃‍♀️‍➡️ 🏃‍➡️ 💨
かんき	かんき 🪟
シアン	シアン 🩵
急げ	急げ 💨
がすすたんど	がすすたんど ⛽️
ぼでぃびるだー	ぼでぃびるだー 🏋️
タマル	タマル 🫔
冷や汗笑顔	冷や汗笑顔 😅
ジャンプ	ジャンプ 🦘
10時	10時 🕙️
ホッケー	ホッケー 🏑 🏒
かいしゃいん	かいしゃいん 👔 👨‍💼 👩‍💼 🧑‍💼
スプマンテ	スプマンテ 🍾 🥂
花見(さくら）	花見(さくら） 🌸
エンゼル	エンゼル 👼
たいくつ	たいくつ 🥱
かんだ	かんだ 🪯
団子	団子 🎑
デザート	デザート 🍡 🍦 🍧 🍨 🍩 🍪 🍫 🍮 🍰
時計（1時）	時計（1時） 🕐️
吸血鬼	吸血鬼 ⚰️ 🦇 🧛 🧛‍♀️ 🧛‍♂️
トド	トド 🦭
かわいい	かわいい 💞 💞 💠 💠 🩵 🩵 🩷 🩷
5じ	5じ 🕔️
あんぜん	あんぜん 🔐 🛟 🦺
じにー	じにー 🧞
いいえ	いいえ 🙂‍↔️ 🙂‍↔️
りこーだー	りこーだー 🪈
でぃなー	でぃなー 🍴 🍽️
仏領ギアナ	仏領ギアナ 🇬🇫
マイクロバス	マイクロバス 🚐
カレンダー	カレンダー 📅 📆 🗓️
ぐれなだ	ぐれなだ 🇬🇩
東京タワー	東京タワー 🗼
困り	困り 😓
しょんぼり	しょんぼり 😔 😔
左右矢印	左右矢印 ↔️
レスリング大会	レスリング大会 🤼 🤼‍♀️ 🤼‍♂️
反射	反射 🦺 🪞
くじゃく	くじゃく 🦚
TMマーク	TMマーク ™️
えんさつ	えんさつ 💴
すかーふのじょせい	すかーふのじょせい 🧕
温度	温度 🌡️
けんせつちゅう	けんせつちゅう 🏗️
メキシコ料理	メキシコ料理 🌮 🌯
ふじんぼうし	ふじんぼうし 👒
四つ葉	四つ葉 🍀
アメリカ大陸	アメリカ大陸 🌎️
まえをむいているひよこ	まえをむいているひよこ 🐥
一つ目	一つ目 👁️
トラ	トラ 🐅 🐯
しんぞう	しんぞう 🩺 🫀
てでかく	てでかく ✍️
ポイ捨て禁止	ポイ捨て禁止 🚯
おまわりさん	おまわりさん 👮 👮‍♀️ 👮‍♂️
ろうそく	ろうそく 🕯️ 🕯️
すすき	すすき 🌾 🎑
うちあげはなび	うちあげはなび 🎆
いいね	いいね 👍️ 👍️
ひとつめ	ひとつめ 👁️
横目	横目 😒
バッテリー残量低下	バッテリー残量低下 🪫
きらきら	きらきら ✨️ ✨️ ❇️ 🌟 🌟 💖 💖 💫 💫 🪩
ドレス	ドレス 👗 🥻
おかし	おかし 🍘 🍦 🍧 🍨 🍩 🍪 🍫 🍬 🍭 🍮 🍰 🍿 🎂 🥧 🧁
にやっと笑う	にやっと笑う 😁
リビア	リビア 🇱🇾
がか	がか 🎨 👨‍🎨 👩‍🎨 🧑‍🎨
指差し確認右	指差し確認右 👉️
だんせいかしゅ	だんせいかしゅ 👨‍🎤
衛星アンテナ	衛星アンテナ 📡
差し出す	差し出す 🫴
シャボン玉	シャボン玉 🫧
どるきごう	どるきごう 💲
めがね	めがね 👓️ 👓️ 🕶️ 😎 🤓 🥸 🧐
がく	がく 🖼️
おかゆ	おかゆ 🥣 🥣
宝石	宝石 💎
営業日	営業日 🈺
じゅうごや	じゅうごや 🎑
おかね	おかね 💰️ 💱 💲 💳️ 💴 💵 💶 💷 💸 🤑 🧧 🪙 🫰
じゅうごよ	じゅうごよ 🎑
マウンテンバイクに乗る人	マウンテンバイクに乗る人 🚵
男性会社員	男性会社員 👨‍💼
自動車	自動車 🚗 🚘️ 🚙 🛞 🛻
あめーば	あめーば 🦠
くすくす	くすくす 🤭
おうし座	おうし座 ♉️ 🐂
げつがく	げつがく 🈷️
めがみ	めがみ 🗽
ＩＤマーク	ＩＤマーク 🆔
ゆきぐも	ゆきぐも 🌨️
ヤシの実	ヤシの実 🥥
冷たい	冷たい 🧊
ふらんすぱん	ふらんすぱん 🥖
りゃくだつ	りゃくだつ 🏴‍☠️
ビーチパラソル	ビーチパラソル 🏖️
くちなし	くちなし 😶
Rマーク	Rマーク ®️
スコットランド	スコットランド 🏴󠁧󠁢󠁳󠁣󠁴󠁿
うすげ	うすげ 👴
フライングディスク	フライングディスク 🥏
容器	容器 🪣 🫙
感激	感激 🥲
7時半	7時半 🕢️
南東	南東 ↘️
おうぞく	おうぞく 👑 🤴 🫅
数字	数字 🔢
感嘆符	感嘆符 ‼️ ❗️
にんじゃ	にんじゃ 🥷
スタジオマイク	スタジオマイク 🎙️
！	！ ‼️ ⁉️ ⚠️ ⚠️ ❕️ ❗️ ❗️
婦人服	婦人服 👚
おひつじ座	おひつじ座 ♈️ 🐏
＃	＃ #️⃣ 💢 💢
プエルトリコ	プエルトリコ 🇵🇷
レッドロブスター	レッドロブスター 🦞
数学	数学 🟰
＋	＋ ➕️
スピーカー音量小	スピーカー音量小 🔉
ユダヤ教	ユダヤ教 ✡️ 🔯 🕍 🕎
ジョリー・ロジャー	ジョリー・ロジャー 🏴‍☠️
にんじん	にんじん 🥕
／	／ ➗️
ずっとも	ずっとも 👯
０	０ 0️⃣
じゅにゅう	じゅにゅう 👨‍🍼 👩‍🍼 🤱 🧑‍🍼
キャラクター（挙手）	キャラクター（挙手） 🙋
１	１ 1️⃣
２	２ 2️⃣
ファーストフード	ファーストフード 🍔
くしゃみする顔	くしゃみする顔 🤧
３	３ 3️⃣
満マーク	満マーク 🈵
４	４ 4️⃣
すきゅーば	すきゅーば 🤿 🥽
５	５ 5️⃣
６	６ 6️⃣
穀物	穀物 🌾
女性の建設作業員	女性の建設作業員 👷‍♀️
７	７ 7️⃣
８	８ 8️⃣
きゃりーけーす	きゃりーけーす 🧳
９	９ 9️⃣
プログラマー	プログラマー 👨‍💻 👩‍💻
映画館	映画館 🎦
トイレ	トイレ 🚹️ 🚺️ 🚻 🚽 🚾 🪠
だがー	だがー 🗡️
？	？ ⁉️ ❓️ ❓️ ❔️
じとめ	じとめ 😒
こどもふたり	こどもふたり 🧑‍🧑‍🧒‍🧒 🧑‍🧒‍🧒
Ａ	Ａ 🅰️
Ｂ	Ｂ 🅱️
金髪	金髪 👩 👩‍🦰 👩‍🦱 👩‍🦲 👩‍🦳 👱 👱‍♀️ 👱‍♂️ 👵
ひっかけ	ひっかけ 🪝
ビリヤード	ビリヤード 🎱
牡牛	牡牛 🐂
だんせいのげいじゅつか	だんせいのげいじゅつか 👨‍🎨
11:00	11:00 🕚️ 🕚️
ビデオゲーム	ビデオゲーム 🎮️ 🕹️
Ｏ	Ｏ 🅾️
かすたーど	かすたーど 🍮
すけーとぼーど	すけーとぼーど 🛹
シューズ	シューズ 🩰
バター	バター 🧈
やぎゅう	やぎゅう 🦬
やぎざ	やぎざ ♑️ 🐐
びでおてーぷ	びでおてーぷ 📼
ひだりかーぶやじるし	ひだりかーぶやじるし ↪️
トロピカル	トロピカル 🍋‍🟩 🍍 🍹 🥭
自転車に乗る女	自転車に乗る女 🚴‍♀️
さーふぃんするおんな	さーふぃんするおんな 🏄‍♀️
みかづき	みかづき ☪️ 🌒 🌘 🌙 🌛
まいなす	まいなす ➖️
猫のキス	猫のキス 😽
仮面	仮面 🎭️
男のゾンビ	男のゾンビ 🧟‍♂️
くもり	くもり ☁️ ☁️ ⛅️ 🌥️ 🌦️ 🌫️
軽い	軽い 🪶
えれべーたー	えれべーたー 🛗
ホーム	ホーム 🏡
ろーどばいく	ろーどばいく 🚴
だんせいのまーく	だんせいのまーく ♂️
ばるかんのあいさつ	ばるかんのあいさつ 🖖
結晶	結晶 ❄️
くもん	くもん 😧
じーぱん	じーぱん 👖
かんどう	かんどう 🥲
かけがね	かけがね 🪝
パトカー	パトカー 🚓 🚔️ 🚨
ブルズアイ	ブルズアイ 🎯
かいわのふきだし	かいわのふきだし 💬
えいしゃき	えいしゃき 📽️
あおむらさき	あおむらさき 🪻
ホール	ホール ⛳️
フェイスマッサージ中の男	フェイスマッサージ中の男 💆‍♂️
時計（２時）	時計（２時） 🕑️
マウス	マウス 🐁 🖱️
記念日	記念日 👨‍❤️‍👨 👨‍❤️‍💋‍👨 👩‍❤️‍👨 👩‍❤️‍👩 👩‍❤️‍💋‍👨 👩‍❤️‍💋‍👩 💏 💑 💕 💝
2い	2い 🥈
びーず	びーず 🧿
みざる	みざる 🙈
救助隊	救助隊 ⛑️ 🧑‍🚒
けいかん	けいかん 👮 👮‍♀️ 👮‍♂️
びーち	びーち ⛱️ 🌴 🏖️ 👙
しんがぽーる	しんがぽーる 🇸🇬
えんげい	えんげい 🎭️
トーク	トーク 💬
ぶろんず	ぶろんず 🥉
はーとぶれいく	はーとぶれいく 💔
トーゴ	トーゴ 🇹🇬
ぶたの鼻	ぶたの鼻 🐽
ふきだしのめ	ふきだしのめ 👁️‍🗨️
onやじるし	onやじるし 🔛
さんかく	さんかく 🔺 🔻 🔼 🔽
びーと	びーと 🪘
庭付きの家	庭付きの家 🏡
障がい	障がい 👨‍🦯 👨‍🦯‍➡️ 👨‍🦼 👨‍🦼‍➡️ 👨‍🦽 👨‍🦽‍➡️ 👩‍🦯 👩‍🦯‍➡️ 👩‍🦼 👩‍🦼‍➡️ 👩‍🦽 👩‍🦽‍➡️ 🦮 🦯 🧏 🧏‍♀️ 🧏‍♂️ 🧑‍🦯 🧑‍🦯‍➡️ 🧑‍🦼 🧑‍🦼‍➡️ 🧑‍🦽 🧑‍🦽‍➡️ 🩼
びーる	びーる 🍺 🍻
えんげき	えんげき 🎭️
止めピン	止めピン 🧷
すぱげってぃ	すぱげってぃ 🍝
イカ	イカ 🦑
イヌ	イヌ 🐕️ 🐶
2じ	2じ 🕑️
うぃんくするかお	うぃんくするかお 😉
スロット（スリーセブン）	スロット（スリーセブン） 🎰
泣き笑い（ネコ）	泣き笑い（ネコ） 😹
ニウエ	ニウエ 🇳🇺
ぶろんど	ぶろんど 👩 👩‍🦰 👩‍🦱 👩‍🦲 👩‍🦳 👱 👱‍♀️ 👱‍♂️ 👵
縫う	縫う 🪡
にじゅうかんたんふ	にじゅうかんたんふ ‼️
快速艇	快速艇 🚤
びーふ	びーふ 🥩
ネズミ	ネズミ 🐀 🐁 🐭 🐹
ほっとした顔	ほっとした顔 😌
めーく	めーく 💄 🪞
11:30	11:30 🕦️ 🕦️
ぺーじにふせん	ぺーじにふせん 📑
イモ	イモ 🥔
ぼうるとすぷーん	ぼうるとすぷーん 🥣
はいそう	はいそう 📦️ 🚚
竜脚類	竜脚類 🦕
うそつき	うそつき 🤥
きかんしゃ	きかんしゃ 🚂
大泣き	大泣き 😭
オウム	オウム 🦜
ばたふらい	ばたふらい 🦋
せんとるしあ	せんとるしあ 🇱🇨
月極	月極 🈷️
しんせい	しんせい 🈸
メトロ	メトロ 🚇️
のめないみず	のめないみず 🚱
びっくりがお	びっくりがお 😯
だーつ	だーつ 🎯
１８きん	１８きん 🔞
麦わら帽子	麦わら帽子 👒
はしご	はしご 🪜 🪜
めーる	めーる ✉️ 📤️ 📥️ 📧 📨 📩 📪️ 📫️
夜の都会	夜の都会 🌃
スイミング	スイミング 🏊️ 🏊‍♀️ 🏊‍♂️
いたりあ	いたりあ 🇮🇹
ぶーべとう	ぶーべとう 🇧🇻
はぐるま	はぐるま ⚙️
エクスクラメーションマーク	エクスクラメーションマーク ‼️ ❕️ ❗️ ❣️
ジャージー	ジャージー 🇯🇪
いたちょこ	いたちょこ 🍫
あかんぼう	あかんぼう 👶 🚼️
目玉焼き	目玉焼き 🍳
すろーする	すろーする 🤾 🤾‍♀️
ていきど	ていきど 🔅
ばりやふりー	ばりやふりー ♿️
えきべん	えきべん 🍱
ボルトとナット	ボルトとナット 🔩
ミニディスク	ミニディスク 💽
ドラム	ドラム 🥁 🪘
シールド	シールド 🛡️
はしる	はしる 🏃 🏃‍♀️ 🏃‍♀️‍➡️ 🏃‍➡️ 💨
しへい	しへい 💴 💵 💶 💷 💸
波浪	波浪 🌊
マトリョーシカ	マトリョーシカ 🪆
生理	生理 🩸
長椅子	長椅子 🛋️
ちきゅう	ちきゅう 🌍️ 🌎️ 🌏️ 🌐
よつばのくろーばー	よつばのくろーばー 🍀
えるく	えるく 🫎
ユーレイ	ユーレイ 👻
ゼブラ	ゼブラ 🦓
ぴにゃーた	ぴにゃーた 🪅
たいがー	たいがー 🐅
でんしゃしょうめん	でんしゃしょうめん 🚆
さむいかお	さむいかお 🥶
シルエット	シルエット 👤 👥 🗣️
ばいく	ばいく 🏍️ 🛵
グアテマラ	グアテマラ 🇬🇹
さーかすごや	さーかすごや 🎪
チンゲン菜	チンゲン菜 🥬
ぼくしんぐ	ぼくしんぐ 🥊
はにーぽっと	はにーぽっと 🍯
２４HOURS（コンビニ)	２４HOURS（コンビニ) 🏪
フラットシューズ	フラットシューズ 🥿
新幹線	新幹線 🚄 🚅
ゴルフをする男	ゴルフをする男 🏌️‍♂️
公園（噴水）	公園（噴水） ⛲️
信号	信号 🚥 🚦
ばいす	ばいす 🗜️
花札	花札 🎴
ぴくるす	ぴくるす 🥒
あかちょうちん	あかちょうちん 🏮
たからもの	たからもの 🏴‍☠️
ジーンズ	ジーンズ 👖
こぜにいれ	こぜにいれ 👛
かんがえこむかお	かんがえこむかお 😔
ぶるーじーんず	ぶるーじーんず 👖
しんしぐつ	しんしぐつ 👞
ますくがお	ますくがお 😷
えるふ	えるふ 🧝 🧝‍♀️ 🧝‍♂️
花束	花束 💐
つかれたかお	つかれたかお 😫
七面鳥	七面鳥 🦃
ベランダ	ベランダ 🪴
雪だるま	雪だるま ☃️ ⛄️
重量挙げをする人	重量挙げをする人 🏋️
ぶろーどばんど	ぶろーどばんど 🛜
ミルク	ミルク 🍼 🤱 🥛
あつい	あつい 🔥 🫠
ちょうだい	ちょうだい 🫴 🫴
南極	南極 🇦🇶
リップスティック	リップスティック 💄
手品	手品 🪄
消防車	消防車 🚒
現金自動預け払い機	現金自動預け払い機 🏧
あつぎ	あつぎ 🧣 🧥
ハイウェイ	ハイウェイ 🛣️
バンザイ	バンザイ 🙌
北西	北西 ↖️
男性の建設作業員	男性の建設作業員 👷‍♂️
引き出し	引き出し 🗄️
国際連合	国際連合 🇺🇳
あつさ	あつさ 🥵
セラピー	セラピー 💆
くちのないかお	くちのないかお 😶
ひじゃぶ	ひじゃぶ 🧕
てのひら	てのひら ✋️ 👐
さうじあらびあ	さうじあらびあ 🇸🇦
謎の人	謎の人 👤
ショッピングバッグ	ショッピングバッグ 🛍️
マウンテンバイクに乗る女	マウンテンバイクに乗る女 🚵‍♀️
きゃんどる	きゃんどる 🕯️
表情（困惑）	表情（困惑） 😖
わらぶきこや	わらぶきこや 🛖
押す	押す 🫷 🫸
ぶらうす	ぶらうす 👚
戦闘	戦闘 🪖
オレンジ	オレンジ 🍊 🔶 🔸 🟠 🟧 🧡
妊娠した人	妊娠した人 🫃 🫄
ブリトー	ブリトー 🌯
まきわり	まきわり 🪓
表情（笑顔）	表情（笑顔） 😃
つぎのしーん	つぎのしーん ⏭️
きういふるーつ	きういふるーつ 🥝
すぱいす	すぱいす 🫚
かうぼーい	かうぼーい 🤠
すりーせぶん	すりーせぶん 🎰
魔術師	魔術師 🧙 🪄
ジェスチャー（ダメ）	ジェスチャー（ダメ） 🙅
くちびるをかんでいるくち	くちびるをかんでいるくち 🫦
骸骨	骸骨 ☠️ 💀
どらいばー	どらいばー 🪛
カルサ	カルサ 🪯
血液型	血液型 🅰️ 🅱️ 🅾️ 🆎
アミューズメントパーク	アミューズメントパーク 🎡 🎢
すぴーかーおんりょうだい	すぴーかーおんりょうだい 🔊
両手	両手 🙌 🤲
カードファイルボックス	カードファイルボックス 🗃️
といれっとぺーぱー	といれっとぺーぱー 🧻
ツバル	ツバル 🇹🇻
とうがらし	とうがらし 🌶️ 🌶️ 🫑 🫑
じゃがいも	じゃがいも 🥔 🥔
女性の教師	女性の教師 👩‍🏫
パナマ	パナマ 🇵🇦
男性と男の子の家族	男性と男の子の家族 👨‍👦
てがき	てがき ✍️
ばんじょー	ばんじょー 🪕
せいめい	せいめい 🧬
挨拶	挨拶 🫂
やまをのぼるおとこ	やまをのぼるおとこ 🧗‍♂️
ターバンの人	ターバンの人 👳
火山	火山 🌋
ふらいぱん	ふらいぱん 🍳
たすき	たすき 🎽 🎽
IDマーク	IDマーク 🆔
衝突	衝突 💥
ナイフとフォークと皿	ナイフとフォークと皿 🍽️
方向	方向 🫱 🫲
100てんまんてん	100てんまんてん 💯
したにむけたて	したにむけたて 🫳
たまねぎ	たまねぎ 🧅
拍手	拍手 👏
マルチタスク	マルチタスク 🤹 🤹‍♂️
花火	花火 🎆 🎇 🧨
うけつけじょう	うけつけじょう 💁
眠そうな顔	眠そうな顔 😪
ふぇんしんぐをするひと	ふぇんしんぐをするひと 🤺
むすめ	むすめ 👧
星空	星空 🌃 🌌
巨大勢力	巨大勢力 🦸
すぼめる	すぼめる 🤌 🤌
ぶっくまーく	ぶっくまーく 🔖
ちゅうかかし	ちゅうかかし 🥮
ふんわり	ふんわり 🧇 🧇
不機嫌な人	不機嫌な人 🙎
てがみ	てがみ ✉️ 💌 📧 📨 📮
けんびきょう	けんびきょう 🔬
endやじるし	endやじるし 🔚
変装	変装 🥸
赤道ギニア	赤道ギニア 🇬🇶
ふらふら	ふらふら 😵 😵 😵‍💫 😵‍💫
エビフライ	エビフライ 🍤
すこあ	すこあ 🎼
小学校	小学校 🎒
くろーる	くろーる 🏊️
えりまき	えりまき 🧣
きょうがく	きょうがく 😲
えすえる	えすえる 🚂
めうし	めうし 🐄
イヌの顔	イヌの顔 🐶
赤ピーマン	赤ピーマン 🫑
一角獣	一角獣 🦄
ヤシの木	ヤシの木 🌴
なふだ	なふだ 📛
電話のジェスチャー	電話のジェスチャー 🤙
バミューダ	バミューダ 🇧🇲
100点満点	100点満点 💯
うえ	うえ ⏫️ ☝️ ⤴️ ⬆️ 👆️ 👍️ 🔝 🔺 🔼 🖕 🫴
案内する男	案内する男 💁‍♂️
しんじゅ	しんじゅ 🦪
どきどき	どきどき 💓 💗
コロンビア	コロンビア 🇨🇴
うぉりすふつな	うぉりすふつな 🇼🇫
ジグソーパズル	ジグソーパズル 🧩
煮込み	煮込み 🍲
バレンタインデー	バレンタインデー 💌 💝
携帯電話禁止	携帯電話禁止 📵
きうい	きうい 🥝
きりのとかい	きりのとかい 🌁
矢印（右）	矢印（右） ➡️
うし	うし 🐂 🐃 🐄 🐮 🐮 🦬
利口	利口 🤓
すりらんか	すりらんか 🇱🇰
略奪	略奪 🏴‍☠️
うず	うず 🌀 🍥
ぱんちぱーま	ぱんちぱーま 🦱
三輪タクシー	三輪タクシー 🛺
石像	石像 🗿
うそ	うそ 🤥
じんじゃー	じんじゃー 🫚
さもあ	さもあ 🇼🇸
うた	うた 🎤
かぬー	かぬー 🚣 🚣‍♀️ 🚣‍♂️ 🛶
うち	うち 🏡
ファンタジー	ファンタジー 🐦‍🔥 🧌 🧙 🧚 🧝 🧞
fax	fax 📠 📠
アスリート	アスリート 🤾
うで	うで 💪 🦾
むぎわらぼうし	むぎわらぼうし 👒
なやむかお	なやむかお 😟
表情（にこにこ）	表情（にこにこ） 😊
えのぐぱれっと	えのぐぱれっと 🎨
どうぶつ	どうぶつ 🐀 🐁 🐂 🐃 🐄 🐅 🐆 🐇 🐈️ 🐈‍⬛ 🐉 🐊 🐋 🐍 🐎 🐏 🐐 🐑 🐒 🐓 🐔 🐕️ 🐖 🐗 🐘 🐙 🐚 🐟️ 🐠 🐡 🐢 🐣 🐤 🐥 🐦️ 🐧 🐨 🐩 🐪 🐫 🐬 🐭 🐮 🐯 🐰 🐱 🐲 🐳 🐴 🐵 🐶 🐷 🐸 🐹 🐺 🐻 🐻‍❄️ 🐼 🐽 🐾 🐿️ 🕊️ 😸 😹 😺 😻 😼 😽 😾 😿 🙀 🙈 🦀 🦁 🦃 🦄 🦅 🦆 🦇 🦈 🦉 🦊 🦌 🦍 🦎 🦏 🦐 🦑 🦒 🦓 🦔 🦘 🦙 🦛 🦜 🦝 🦞 🦡 🦢 🦣 🦥 🦦 🦧 🦨 🦩 🦫 🦬 🦭 🫎 🫏
デスクトップパソコン	デスクトップパソコン 🖥️
うん	うん 🙂‍↕️ 🙂‍↕️
男のエルフ	男のエルフ 🧝‍♂️
ちょうみりょう	ちょうみりょう 🧂 🫙
横笛	横笛 🪈
無マーク	無マーク 🈚️
オレンジのハート	オレンジのハート 🧡
たまごからかえったひよこ	たまごからかえったひよこ 🐣
もんばん	もんばん 💂 💂‍♀️ 💂‍♂️
メーク	メーク 💄 🪞
ハイキング	ハイキング 🚶 🚶‍♀️ 🚶‍♀️‍➡️ 🚶‍➡️ 🥾
あぼかど	あぼかど 🥑
うま	うま 🎠 🏇 🐎 🐴 🐴 🫏
ＯＫ！	ＯＫ！ 👌
うみ	うみ 🌊 🏄️ 🔱 🪸 🪼
詮索好き	詮索好き 🦝
ソフトボール	ソフトボール 🥎
11じ	11じ 🕚️
てをつなぐだんせい	てをつなぐだんせい 👬
小文字	小文字 🔡
12じはん	12じはん 🕧️
soonやじるし	soonやじるし 🔜
まっしゅるーむ	まっしゅるーむ 🍄 🍄‍🟫
男性と男性と男の子の家族	男性と男性と男の子の家族 👨‍👨‍👦
さんたさん	さんたさん 🧑‍🎄
でりばりー	でりばりー 🥡
足跡（犬）	足跡（犬） 🐾
孔雀	孔雀 🦚
生まれ変わり	生まれ変わり 🐦‍🔥
にんげん	にんげん 👱
バスケ	バスケ ⛹️ ⛹️‍♀️ ⛹️‍♂️ 🏀
おうじょ	おうじょ 👸
ビデオテープ	ビデオテープ 📼
おりえんてーりんぐ	おりえんてーりんぐ 🧭
ひらいたりょうて	ひらいたりょうて 👐
じゃし	じゃし 🧿
メール	メール ✉️ 📧
ザリガニ	ザリガニ 🦞
ほくとう	ほくとう ↗️
ぱどる	ぱどる 🚣
こぴーき	こぴーき 🖨️
時計（８時）	時計（８時） 🕗️
きゃらくたー	きゃらくたー 🙍 🙎
採掘	採掘 ⛏️
じょうはんしん	じょうはんしん 👤 👥
えいまーく	えいまーく 🈺
ノート	ノート 📒 📓 📔 🗒️
歯ブラシ	歯ブラシ 🪥
まえのきょくぼたん	まえのきょくぼたん ⏮️
まんいん	まんいん 🈵
わいんぐらす	わいんぐらす 🍷
くせげ	くせげ 🦱
ハロウィンかぼちゃ	ハロウィンかぼちゃ 🎃
卵割り	卵割り 🐣
べーる	べーる 👰 👰‍♀️ 👰‍♂️ 🧕
あかんべー	あかんべー 👅
化粧室	化粧室 🚹️ 🚺️ 🚻 🚾
ボタン式電話	ボタン式電話 ☎️
不毛｜干ばつ｜葉のない木｜冬	不毛｜干ばつ｜葉のない木｜冬 🪾
会社員	会社員 👔 👨‍💼 👩‍💼 🧑‍💼
個人	個人 🔏
かいがら	かいがら 🐚
ふほんい	ふほんい 😦
エンピツ	エンピツ ✏️
れいはいじょ	れいはいじょ 🛐
指差し	指差し ☝️ 👆️ 👇️ 👈️ 👉️ 🖕 🫵
でゅえる	でゅえる 🤼 🤼‍♀️ 🤼‍♂️
エビ天	エビ天 🍤
みずでっぽう	みずでっぽう 🔫
かくとう	かくとう 🤼 🤼‍♀️ 🤼‍♂️
チェックボックス	チェックボックス ☑️
かぜにゆれるは	かぜにゆれるは 🍃
じょせいのこっく	じょせいのこっく 👩‍🍳
茶碗	茶碗 🍵
じゅにゅうするじょせい	じゅにゅうするじょせい 👩‍🍼
ぎんいろ	ぎんいろ 🩶
もなこ	もなこ 🇲🇨
つきまーく	つきまーく 🈷️
ロブスター	ロブスター 🦞
だんせいのあくやく	だんせいのあくやく 🦹‍♂️
印刷機	印刷機 🖨️
せいそう	せいそう 🤵
重量挙げをする女	重量挙げをする女 🏋️‍♀️
ディエゴガルシア島	ディエゴガルシア島 🇩🇬
男性と男性と女の子の家族	男性と男性と女の子の家族 👨‍👨‍👧
sos	sos 🆘
ぺーぱーくりっぷ	ぺーぱーくりっぷ 📎 🖇️
にっこりキス	にっこりキス 😙
ハンググライダー	ハンググライダー 🪂
アフガニスタン	アフガニスタン 🇦🇫
おんせん	おんせん ♨️
ごみ箱	ごみ箱 🗑️ 🚮
てーぷ	てーぷ 📼
灰色のハート	灰色のハート 🩶
下指差し	下指差し 👇️
有袋類	有袋類 🦘
ひこうき	ひこうき ✈️ 🛩️ 🛫 🛬
敬礼する顔	敬礼する顔 🫡
つうかん	つうかん 🛃
ブリーフ	ブリーフ 🩲
競技場	競技場 🏟️
中毒	中毒 🥴
ドミニカ国	ドミニカ国 🇩🇲
ぴかぴかはーと	ぴかぴかはーと 💖
ウッシッシ	ウッシッシ 😁
じゃー	じゃー 🫙
ふしん	ふしん 🤨 🫤
ふぁーてぃま	ふぁーてぃま 🪬
のーふぉーくとう	のーふぉーくとう 🇳🇫
ぽんど	ぽんど 💷
ぺろぺろきゃんでぃ	ぺろぺろきゃんでぃ 🍭
ほうちょう	ほうちょう 🔪
こーむ	こーむ 🪮
ふらんす	ふらんす 🇫🇷 🥐
鳥の巣	鳥の巣 🪺
いんぐらんど	いんぐらんど 🏴󠁧󠁢󠁥󠁮󠁧󠁿
カトラリー	カトラリー 🍴 🥄
かみそり	かみそり 🪒 🪒
だーびー	だーびー 🐎
こーと	こーと 🧥
しょうがくせい	しょうがくせい 🎒
げんつき	げんつき 🛵
閉じた錠とペン	閉じた錠とペン 🔏
ステッチ	ステッチ 🪡
またか	またか 🤦 🤦 🤦‍♀️ 🤦‍♀️ 🤦‍♂️ 🤦‍♂️
おとこのまほうつかい	おとこのまほうつかい 🧙‍♂️
こーん	こーん 🌽
めりーごーらうんど	めりーごーらうんど 🎠
ほぞん	ほぞん 🫙
信仰	信仰 🪯
ぼうぐらふ	ぼうぐらふ 📊
レソト	レソト 🇱🇸
ステッキ	ステッキ 🩼
ろーしょん	ろーしょん 🧴
ゆうえんち	ゆうえんち 🎠 🎡 🎢
レインボー	レインボー 🌈
ウィンク	ウィンク 😉 😜
ふぉんでゅ	ふぉんでゅ 🫕
いんやん	いんやん ☯️
呆然	呆然 😦
はいしゃ	はいしゃ 🦷
ジャグリングをする人	ジャグリングをする人 🤹
クリームチーズ	クリームチーズ 🥯
オランダ領カリブ	オランダ領カリブ 🇧🇶
アメリカンフットボール	アメリカンフットボール 🏈
温泉	温泉 ♨️
ろーろでっくす	ろーろでっくす 📇
ないふとふぉーくとさら	ないふとふぉーくとさら 🍽️
心臓	心臓 🩺 🫀
男性と男性でキス	男性と男性でキス 👨‍❤️‍💋‍👨
またね	またね 👋 👋
スクールバス	スクールバス 🚌
とおんきごう	とおんきごう 🎼
だっしゅ	だっしゅ 💨
しんか	しんか 🧬
はらぺこ	はらぺこ 😋 😩
茶色いハート	茶色いハート 🤎
ほうそう	ほうそう 📢 📻️
ぷれっつぇる	ぷれっつぇる 🥨
空飛ぶ円盤	空飛ぶ円盤 🛸
おらんうーたん	おらんうーたん 🦧
満（満室）	満（満室） 🈵
睡眠	睡眠 🛏️
世界地図	世界地図 🗺️
パイナップル	パイナップル 🍍
しーふーど	しーふーど 🥘 🦐 🦑 🦞 🦪
れたす	れたす 🥬
しんめ	しんめ 🌱
ちりょう	ちりょう ⚕️
人を指差している手	人を指差している手 🫵
不機嫌な女	不機嫌な女 🙎‍♀️
歩く	歩く 🚶 🚶‍♀️ 🚶‍♀️‍➡️ 🚶‍➡️
ふらめんこ	ふらめんこ 💃 🕺
つながったくりっぷ	つながったくりっぷ 🖇️
生ガキ	生ガキ 🦪
ふくろう	ふくろう 🦉
前のトラック	前のトラック ⏮️
しんわ	しんわ 🐦‍🔥 🧚 🧝 🧞 🪽
ばげっじくれーむ	ばげっじくれーむ 🛄
ほいーる	ほいーる 🛞
少し困った顔	少し困った顔 🙁
すにーかー	すにーかー 👟
かいてんもくば	かいてんもくば 🎠
治療	治療 ⚕️
爆発	爆発 💣️ 💥 🤯 🧨
男性と女の子と男の子の家族	男性と女の子と男の子の家族 👨‍👧‍👦
イノシシ	イノシシ 🐗
幼稚園	幼稚園 📛
みーとそーす	みーとそーす 🍝
ぐりーんらんど	ぐりーんらんど 🇬🇱
マーマン	マーマン 🧜‍♂️
ローション	ローション 🧴
むらさきのまる	むらさきのまる 🟣
フランスパン	フランスパン 🥖
いんど	いんど 🇮🇳
てきちゅう	てきちゅう 🎯
ヨガ行者	ヨガ行者 🧘
ずる賢い	ずる賢い 🦝
スピードボート	スピードボート 🚤
てをつなぐだんじょ	てをつなぐだんじょ 👫
郵便ポスト	郵便ポスト 📮
1234	1234 🔢 🔢
しろくま	しろくま 🐻‍❄️
おうさま	おうさま 🫅
バッテリー	バッテリー 🔋 🪫
案内所	案内所 ℹ️
じょせいのせいびし	じょせいのせいびし 👩‍🔧
ひこう	ひこう 🪽
くろでんわ	くろでんわ ☎️
ぺあ	ぺあ 👯
飾り1	飾り1 💟
ひやあせ	ひやあせ 😅 😓 😰
ちゃんぴおん	ちゃんぴおん 🏆️
2じはん	2じはん 🕝️
左斜め上	左斜め上 ↖️
左斜め下	左斜め下 ↙️
合格マーク	合格マーク 🈴
かいようせいぶつ	かいようせいぶつ 🪼
タイタニック号	タイタニック号 🚢
港（いかりマーク）	港（いかりマーク） ⚓️
置き時計	置き時計 🕰️
ぐりーん	ぐりーん 🥗
電動車椅子	電動車椅子 🦼
ガチョウ	ガチョウ 🪿
旅客船	旅客船 🛳️
suv	suv 🚙
ばれんたいん	ばれんたいん 💝
サンドイッチ	サンドイッチ 🥪
ぺけ	ぺけ ✖️ ❌️ ❎️
しかめ面の男	しかめ面の男 🙍‍♂️
くりすますとう	くりすますとう 🇨🇽
女性会社員	女性会社員 👩‍💼
紙クリップ	紙クリップ 📎 🖇️
どんぶり	どんぶり 🍜 🍜
だんせいのいしゃ	だんせいのいしゃ 👨‍⚕️
しょうねん	しょうねん 👦
茶色	茶色 🟤 🟫 🤎
さんたくろーす	さんたくろーす 🎅 🤶 🧑‍🎄
マラソン	マラソン 🏃 🏃‍♀️ 🏃‍♀️‍➡️ 🏃‍♂️ 🏃‍♂️‍➡️ 🏃‍➡️
おおまた	おおまた 🚶 🚶‍➡️
くじら	くじら 🐋 🐳 🐳
ぜんきょく	ぜんきょく 🔁
さぎょういん	さぎょういん 👷 👷‍♀️ 👷‍♂️ 🧑‍🔧
どらむかん	どらむかん 🛢️
柑橘類	柑橘類 🍊 🍋 🍋‍🟩
海洋生物	海洋生物 🪼
ハート（黄）	ハート（黄） 💛
おおまる	おおまる 🔴 🔵
ソフトクリーム	ソフトクリーム 🍦
へびつかいざ	へびつかいざ ⛎️ 🐍
坊主	坊主 🦲
へびつかざ	へびつかざ ⛎️
すぷまんて	すぷまんて 🍾 🥂
ぷんぷん	ぷんぷん 😠 😠 😡 😡 😾 😾 🙎 🙎 🙎‍♀️ 🙎‍♀️ 🙎‍♂️ 🙎‍♂️
たんぶらー	たんぶらー 🥃
絶望する猫	絶望する猫 🙀
ぺん	ぺん ✒️ 🖊️ 🖋️
ほにゅう瓶	ほにゅう瓶 🍼
なんちょう	なんちょう 🦻
男性と女の子と女の子の家族	男性と女の子と女の子の家族 👨‍👧‍👧
のみもの	のみもの ☕️ 🍵 🍾 🧃 🧉 🧋 🫖 🫗
トンガ	トンガ 🇹🇴
げすと	げすと 👤
マンテルクロック	マンテルクロック 🕰️
けしょうひん	けしょうひん 💄
たこす	たこす 🌮
そふぁ	そふぁ 🛋️
スリーセブン	スリーセブン 🎰
だんせいのさいばんかん	だんせいのさいばんかん 👨‍⚖️
オベロン	オベロン 🧚
しつれん	しつれん 💔
チェスの駒	チェスの駒 ♟️
しゃしゅ	しゃしゅ 🏹
こうか	こうか 🪙
ゆうぐれ	ゆうぐれ 🌆 🌇
表情（投げキッス）	表情（投げキッス） 😘
こうぎ	こうぎ 🪧
バーベル	バーベル 🏋️
こうぐ	こうぐ ⚒️ ⚙️ ⛏️ 🔧 🔨 🔩 🗜️ 🛠️ 🪓 🪚 🪛
シャンペン	シャンペン 🍾 🥂
コイン	コイン 🪙
ボクシング	ボクシング 🥊
めがはーとのねこ	めがはーとのねこ 😻
こうさ	こうさ 🔀
王冠をかぶった人	王冠をかぶった人 🫅
こうし	こうし 👨‍🏫 👩‍🏫 🧑‍🏫
しゃしん	しゃしん 📷️ 📸
こうじ	こうじ 🏗️ 👷 👷‍♀️ 👷‍♂️ 🦺
Blu-ray	Blu-ray 💿️ 📀
てんせんのかお	てんせんのかお 🫥
うさ耳	うさ耳 👯 👯‍♀️ 👯‍♂️
乗算	乗算 ✖️ ❌️ ❎️
モヤイ像	モヤイ像 🗿
手で書く	手で書く ✍️
ボタン	ボタン ⏏️ ⏩️ ⏫️ ⏬️ ⏭️ ⏮️ ⏯️ ⏸️ ⏹️ ⏺️ ▶️ ◀️ 🔀 🔁 🔂 🔘 🔲 🔳 🔼 🔽
そふと	そふと 🍦
キャッチ	キャッチ 🤾 🤾‍♀️
らぶほてる	らぶほてる 🏩
オオカミ	オオカミ 🐺
スカル	スカル ☠️ 💀
足し算	足し算 ➕️
はやおくりぼたん	はやおくりぼたん ⏩️
こうば	こうば 🏭️
振る	振る 🪇
ぶりとー	ぶりとー 🌯
ファストフード	ファストフード 🍔 🍟
キャップ	キャップ 🧢
バンジョー	バンジョー 🪕
しんげつ	しんげつ 🌑 🌚
山羊	山羊 🐐
下矢印１	下矢印１ ⬇️
下矢印２	下矢印２ ↘️
おとめざ	おとめざ ♍️
てんせい	てんせい 🐦‍🔥
とらんすじぇんだーふらっぐ	とらんすじぇんだーふらっぐ 🏳️‍⚧️
下ボタン	下ボタン 🔽
空色	空色 🩵
ピーチ	ピーチ 🍑
クリップボード	クリップボード 📋️
さかさま	さかさま 🙃 🙃
コート	コート 🧥
ぷりん	ぷりん 🍮
ストップウォッチ	ストップウォッチ ⏱️
ぶたばな	ぶたばな 🐽
松葉杖	松葉杖 🩼
こんわくしたかお	こんわくしたかお 😖
みなみすーだん	みなみすーだん 🇸🇸
あごにて	あごにて 🤔
ヨガのポーズをする人	ヨガのポーズをする人 🧘
ピース	ピース ✌️ 🧩
ろくぼうせい	ろくぼうせい ✡️ 🔯
せいきゅうしょ	せいきゅうしょ 🧾
メッセージ	メッセージ 💬
コーム	コーム 🪮
動物	動物 🐀 🐁 🐂 🐃 🐄 🐅 🐆 🐇 🐈️ 🐈‍⬛ 🐉 🐊 🐋 🐍 🐎 🐏 🐐 🐑 🐒 🐓 🐔 🐕️ 🐖 🐗 🐘 🐙 🐚 🐟️ 🐠 🐡 🐢 🐣 🐤 🐥 🐦️ 🐧 🐨 🐩 🐪 🐫 🐬 🐭 🐮 🐯 🐰 🐱 🐲 🐳 🐴 🐵 🐶 🐷 🐸 🐹 🐺 🐻 🐻‍❄️ 🐼 🐽 🐾 🐿️ 🕊️ 😸 😹 😺 😻 😼 😽 😾 😿 🙀 🙈 🦀 🦁 🦃 🦄 🦅 🦆 🦇 🦈 🦉 🦊 🦌 🦍 🦎 🦏 🦐 🦑 🦒 🦓 🦔 🦘 🦙 🦛 🦜 🦝 🦞 🦡 🦢 🦣 🦥 🦦 🦧 🦨 🦩 🦫 🦬 🦭 🫎 🫏
いはい	いはい ⚱️
たんざにあ	たんざにあ 🇹🇿
両替	両替 💱
れすりんぐをするひと	れすりんぐをするひと 🤼
ぱっく	ぱっく 🏒 📦️ 🧚
にんしんしたひと	にんしんしたひと 🫃 🫄
英字の入力	英字の入力 🔤
左側	左側 🫲
すとっぷうぉっち	すとっぷうぉっち ⏱️
特大四角１	特大四角１ ⬜️
氷点下	氷点下 🥶
特大四角２	特大四角２ ⬛️
だんせいのたんてい	だんせいのたんてい 🕵️‍♂️
ころっけ	ころっけ 🧆
うきわ	うきわ 🛟
けいさつかん	けいさつかん 👮 👮‍♀️ 👮‍♂️
コーン	コーン 🌽
はーとでこれーしょん	はーとでこれーしょん 💟
フレンチフライ	フレンチフライ 🍟
おむすび	おむすび 🍙 🍙
培養	培養 🧫
ジャグリングをする女	ジャグリングをする女 🤹‍♀️
ぺんさき	ぺんさき ✒️
アメーバ	アメーバ 🦠
ブタの顔	ブタの顔 🐷
お守り	お守り 🧿 🪬
焼き芋	焼き芋 🍠
ばりあふりー	ばりあふりー ♿️ 🛗
紫の四角	紫の四角 🟪
くさい	くさい 💩
歯医者	歯医者 🦷
きっくすけーたー	きっくすけーたー 🛴
手（おっはー）	手（おっはー） 👐
ぽかーん	ぽかーん 😦 😦 😯 😯
サイクロン	サイクロン 🌀
ホットスポット	ホットスポット 🛜
すきー	すきー ⛷️ 🎿
矢印（右斜め上）	矢印（右斜め上） ↗️
ボディビルダー	ボディビルダー 🏋️
メリーゴーラウンド	メリーゴーラウンド 🎠
ＡＢ型	ＡＢ型 🆎
じゅんかんやじるし	じゅんかんやじるし ♻️
あせり	あせり 😰
びっくり顔	びっくり顔 😯
短冊	短冊 🎋
ハート（矢がささる）	ハート（矢がささる） 💘
りんぐのーと	りんぐのーと 📒
ハンディカム	ハンディカム 📹️
カンガルー	カンガルー 🦘
ながいす	ながいす 🛋️
ぱらぼらあんてな	ぱらぼらあんてな 📡
小学生	小学生 🎒
溶けそう	溶けそう 🫠
晴れ時々曇り	晴れ時々曇り 🌤️
5じ30ふん	5じ30ふん 🕠️
ブルーベリー	ブルーベリー 🫐
アンゴラ	アンゴラ 🇦🇴
バー（カクテル）	バー（カクテル） 🍸️
くさり	くさり ⛓️ ⛓️ ⛓️‍💥 ⛓️‍💥
ねんれいせいげん	ねんれいせいげん 🔞
怖い	怖い 👹 👻 😨
ぺるー	ぺるー 🇵🇪
とっくみあい	とっくみあい 🤼 🤼‍♀️ 🤼‍♂️
ひなまつり	ひなまつり 🎎
ひぐれ	ひぐれ 🌇
どらいぶ	どらいぶ 🚗 🚘️
ほにゅうびん	ほにゅうびん 🍼
つりー	つりー 🎄
数珠	数珠 📿
かやく	かやく 🧨
かんそく	かんそく 🔭
溶ける	溶ける 🫠
ハチェット	ハチェット 🪓
しょぼり	しょぼり 😔
おみくじ	おみくじ 🥠 🥠
夜景	夜景 🌃 🌉
ちゅっ	ちゅっ 👨‍❤️‍💋‍👨 👨‍❤️‍💋‍👨 👩‍❤️‍💋‍👨 👩‍❤️‍💋‍👨 👩‍❤️‍💋‍👩 👩‍❤️‍💋‍👩 💋 💋 💏 💏 😗 😗 😘 😘 😙 😙 😚 😚 😽 😽
まらうい	まらうい 🇲🇼
たまつき	たまつき 🎱
短刀	短刀 🗡️
ばんど	ばんど 🪈
薬味	薬味 🧂 🧄 🧅 🫚
にくしょくどうぶつ	にくしょくどうぶつ 🐅 🐆
ふけつ	ふけつ 🪰
マテ茶	マテ茶 🧉
わらえない	わらえない 😐️
ぐあむ	ぐあむ 🇬🇺
らとびあ	らとびあ 🇱🇻
バーサス	バーサス 🆚
だんせいとだんせいのかっぷる	だんせいとだんせいのかっぷる 👨‍❤️‍👨
かっと	かっと ✂️ 💇 💇‍♂️
だがっき	だがっき 🪇
うれしなき	うれしなき 😂 🥹
おふぃすびる	おふぃすびる 🏢
もえるはーと	もえるはーと ❤️‍🔥
きゃんぷ	きゃんぷ ⛺️ 🏕️ 🥾
Ｅめーる	Ｅめーる 📧
でにむ	でにむ 👖
段ボール	段ボール 📦️
かっぷ	かっぷ ☕️ 🏆️
召喚	召喚 🧙
メキシコ	メキシコ 🇲🇽 🪅
ほじょ	ほじょ 🐕‍🦺 🦮
しおふき	しおふき 🐳
とらくたー	とらくたー 🚜
シャンプー	シャンプー 🧴
のぞみ	のぞみ 🚅
ゴリラ	ゴリラ 🦍
みぎまわりたてやじるし	みぎまわりたてやじるし 🔃
ますく	ますく 😷 🤿
ひなどり	ひなどり 🐣
おとなふたりとこどもふたりのかぞく	おとなふたりとこどもふたりのかぞく 🧑‍🧑‍🧒‍🧒
つけもの	つけもの 🥒
フライパン（目玉焼き）	フライパン（目玉焼き） 🍳
らじお	らじお 📻️
風邪ひき	風邪ひき 😷
ジャガイモ	ジャガイモ 🥔
十日夜の月	十日夜の月 🌔
じょっきー	じょっきー 🏇
キスマーク	キスマーク 💋
下降	下降 📉
フリー	フリー 🆓
れーしんぐ	れーしんぐ 🏁
短剣	短剣 🗡️
はかり	はかり ⚖️ ⚖️
ちいさいおれんじのひしがた	ちいさいおれんじのひしがた 🔸
家族	家族 👨‍👦 👨‍👦‍👦 👨‍👧 👨‍👧‍👦 👨‍👧‍👧 👨‍👨‍👦 👨‍👨‍👦‍👦 👨‍👨‍👧 👨‍👨‍👧‍👦 👨‍👨‍👧‍👧 👨‍👩‍👦 👨‍👩‍👦‍👦 👨‍👩‍👧 👨‍👩‍👧‍👦 👨‍👩‍👧‍👧 👩‍👦 👩‍👦‍👦 👩‍👧 👩‍👧‍👦 👩‍👧‍👧 👩‍👩‍👦 👩‍👩‍👦‍👦 👩‍👩‍👧 👩‍👩‍👧‍👦 👩‍👩‍👧‍👧 👪️ 🧑‍🧑‍🧒 🧑‍🧑‍🧒‍🧒 🧑‍🧒 🧑‍🧒‍🧒
とじた	とじた 📪️ 📫️
停留所	停留所 🚏
せいようなし	せいようなし 🍐
はかば	はかば 🪦
ミツバチ	ミツバチ 🐝
しもやけ	しもやけ 🥶 🥶
とりだし	とりだし ⏏️
満足	満足 😆 😊
きどにーびーんず	きどにーびーんず 🫘
ばくしょう	ばくしょう 😂 😹 🤣
ー（長音記号２）	ー（長音記号２） ➰️
ついとう	ついとう 🪦
きーぼーど	きーぼーど ⌨️ 🎹
こくれん	こくれん 🇺🇳
パラソル	パラソル ⛱️ 🏖️
スーパーヒーロー	スーパーヒーロー 🦸
イルカ	イルカ 🐬
ロック確認	ロック確認 🔐
韓国国旗	韓国国旗 🇰🇷
ほちょうきをつけたみみ	ほちょうきをつけたみみ 🦻
ちぇっかーふらっぐ	ちぇっかーふらっぐ 🏁
しーえるまーく	しーえるまーく 🆑
ぬいばり	ぬいばり 🧵 🪡
マル得	マル得 🉐
矢印（左斜め下）	矢印（左斜め下） ↙️
はちうえ	はちうえ 🪴
うおざ	うおざ ♓️ 🐟️
黒い鳥	黒い鳥 🐦‍⬛
かちんこ	かちんこ 🎬️
ジンジャー	ジンジャー 🫚
メロメロ	メロメロ 🥰
工事現場の人	工事現場の人 👷
マイナスドライバー	マイナスドライバー 🪛
ろーぷうぇい	ろーぷうぇい 🚡
カエルの顔	カエルの顔 🐸
ボツワナ	ボツワナ 🇧🇼
震えている顔	震えている顔 🫨
ディヤランプ	ディヤランプ 🪔
ガリ勉	ガリ勉 🤓
女子学生	女子学生 👩‍🎓
はっぴーばーすでー	はっぴーばーすでー 🎂 🥳
しゅどうしきくるまいすのひと	しゅどうしきくるまいすのひと 🧑‍🦽 🧑‍🦽‍➡️
あじあ	あじあ 🌏️
すかんく	すかんく 🦨
表情（ぽっ）	表情（ぽっ） 😳
お手上げする人	お手上げする人 🤷
寿司	寿司 🍣
ミミズ	ミミズ 🪱
エジプト	エジプト 🇪🇬
りょうてはーと	りょうてはーと 🫶
おおきなめ	おおきなめ 🥺
レーシング	レーシング 🏁
すいまー	すいまー 🏊️ 🏊‍♀️ 🏊‍♂️
夕暮れ	夕暮れ 🌆 🌇
指差し確認左	指差し確認左 👈️
試験管	試験管 🧪
たすけて	たすけて 🆘
ねむそうなかお	ねむそうなかお 😪
農夫	農夫 👨‍🌾
どるさつ	どるさつ 💵
スリランカ	スリランカ 🇱🇰
よがぎょうじゃ	よがぎょうじゃ 🧘
波線	波線 〰️
ふきげん	ふきげん 😾 🙎 🙎‍♀️ 🙎‍♂️
さいせい	さいせい ⏯️ ▶️ ♻️ 🐦‍🔥
よくできました	よくできました 💮 💮
泡風呂	泡風呂 🛁
けいとらっく	けいとらっく 🛻
ヨガのポーズをする女	ヨガのポーズをする女 🧘‍♀️
ヒトコブラクダ	ヒトコブラクダ 🐪
ぴざ	ぴざ 🍕
中秋節	中秋節 🥮
クラッチバッグ	クラッチバッグ 👝
6時半	6時半 🕡️
満車	満車 🈵
あじみ	あじみ 😝
けんすいしきものれーる	けんすいしきものれーる 🚟
ことわる	ことわる 🫷 🫸
商標マーク	商標マーク ™️
ハムスターの顔	ハムスターの顔 🐹
逆再生	逆再生 ◀️
誕生日	誕生日 🎂 🎉 🥳 🪅
女のエルフ	女のエルフ 🧝‍♀️
おてあげするおとこ	おてあげするおとこ 🤷‍♂️
シャベル	シャベル 🪏
ぴん	ぴん ✅️ 📌 📍
しょべる	しょべる 🪏
受信中	受信中 📨
ぶろっく	ぶろっく 🧱
ハムサ	ハムサ 🪬
こうじょう	こうじょう 🏭️ 🧑‍🏭
爆笑	爆笑 😂 😹 🤣
極楽	極楽 🪷
サウナに入る人	サウナに入る人 🧖
うそつきの顔	うそつきの顔 🤥
引っかけ	引っかけ 🪝
ゔぃおら	ゔぃおら 🎻
しろいはーと	しろいはーと 💟 🤍
ぽりす	ぽりす 👮
爆竹	爆竹 🧨
ひだりむきのこぶし	ひだりむきのこぶし 🤛
すがたみ	すがたみ 🪞
退屈	退屈 🥱
アナグマ	アナグマ 🦡
優勝カップ	優勝カップ 🏆️
かめら	かめら 🎥 🎦 📷️ 📸 📹️ 🤳
かーどふぉるだー	かーどふぉるだー 🗂️
おんなのきゅうけつき	おんなのきゅうけつき 🧛‍♀️
杖をついた人	杖をついた人 🧑‍🦯 🧑‍🦯‍➡️
さいせいぼたん	さいせいぼたん ⏯️ ▶️
ぼくしんぐぐろーぶ	ぼくしんぐぐろーぶ 🥊
光ディスク	光ディスク 💿️
オランウータン	オランウータン 🦧
よこをむいているひよこ	よこをむいているひよこ 🐤
拡声器	拡声器 📢 📣
きんるい	きんるい 🍄 🍄‍🟫
動画	動画 🎦 📹️ 📼
かめん	かめん 🎭️
はーとぽーず	はーとぽーず 🫶
ばはま	ばはま 🇧🇸
りぼん	りぼん 🎀 🎁 🎗️ 💝
おんりょう	おんりょう 🔈️ 🔉 🔊
かおのあるしんげつ	かおのあるしんげつ 🌚
内気	内気 🫥
ギター	ギター 🎸
バーゲン	バーゲン 🉐
フラメンコ	フラメンコ 💃 🕺
ジェスチャー	ジェスチャー 💁 💁‍♀️ 💁‍♂️ 🙅 🙅‍♀️ 🙅‍♂️ 🙆 🙆‍♀️ 🙆‍♂️ 🙇 🙋 🙌 🙏 🤌 🤦 🤦‍♀️ 🤦‍♂️ 🤷 🤷‍♀️ 🤷‍♂️
こんとろーら	こんとろーら 🎮️ 🕹️
ソロモン諸島	ソロモン諸島 🇸🇧
こんとろーる	こんとろーる 🎛️
線香花火	線香花火 🎇
サーカス	サーカス 🎪
エステ	エステ 💆 💆‍♀️ 💆‍♂️
じぶんどり	じぶんどり 🤳
テコンドー	テコンドー 🥋
光るハート	光るハート 💖
ダイヤモンド	ダイヤモンド 💍 💎
びょうげんきん	びょうげんきん 🪰
ばちかんしこく	ばちかんしこく 🇻🇦
せるふぃー	せるふぃー 🤳
まんてるくろっく	まんてるくろっく 🕰️
りぞーと	りぞーと ⛵️
青ざめた顔	青ざめた顔 😨
補助犬	補助犬 🦮
ぴー	ぴー 🅿️
左指差し	左指差し 👈️
びっくりまーく	びっくりまーく ‼️ ⁉️ ❕️ ❗️ ❣️
夜／流れ星	夜／流れ星 🌃
トランペット	トランペット 🎺
おじぎする人	おじぎする人 🙇
しりあ	しりあ 🇸🇾
引く	引く ➖️
緑の丸	緑の丸 🟢
右向きに押している手	右向きに押している手 🫸
べいりょうさもあ	べいりょうさもあ 🇦🇸
文書１	文書１ 📃
文書２	文書２ 📄
ショッピングカート	ショッピングカート 🛒
うすいあお	うすいあお 🩵
うえをみるかお	うえをみるかお 🙄
雪（雪だるま）	雪（雪だるま） ⛄️
Ｂ型	Ｂ型 🅱️
まるちたすく	まるちたすく 🤹 🤹‍♂️
定規	定規 📏 📐
フィルム	フィルム 🎞️ 🎥 📽️
受信なし	受信なし 📥️
ゆびまーく	ゆびまーく 🈯️
しろわくしかく	しろわくしかく 🔳
ふうせん	ふうせん 🎈
ぶつりがくしゃ	ぶつりがくしゃ 🧑‍🔬
くろしかくとくだい	くろしかくとくだい ⬛️
きゅーば	きゅーば 🇨🇺
ようちえん	ようちえん 📛
アルメニア	アルメニア 🇦🇲
チェッカーフラグ（モータースポーツ）	チェッカーフラグ（モータースポーツ） 🏁
札束	札束 💴 💵 💶 💷 💸
ふらふらの顔	ふらふらの顔 🥴
ビジネスパーソン	ビジネスパーソン 👨‍💼 👩‍💼 🧑‍💼
挙手	挙手 ✋️ 🖐️ 🙋 🙋‍♀️ 🙋‍♂️
左右	左右 ↔️
粘土	粘土 🧱
機械工	機械工 🧰
ようせつこう	ようせつこう 🧑‍🏭
朝食	朝食 🍳 🍴 🥣 🥯 🧇
理容院	理容院 💇 💇‍♂️ 💈
じょせいのえいへい	じょせいのえいへい 💂‍♀️
録音録画ボタン	録音録画ボタン ⏺️
ロバ	ロバ 🫏
ログ	ログ 🪵
目が星の笑顔	目が星の笑顔 🤩
食事（ナイフ＆フォーク）	食事（ナイフ＆フォーク） 🍴
応援	応援 📣
消防	消防 🧯
うぃすきー	うぃすきー 🥃
クロール	クロール 🏊️
びたみんざい	びたみんざい 💊
ナウル	ナウル 🇳🇷
水上競技	水上競技 🤽 🤽‍♀️ 🤽‍♂️
ろんぐぶーつ	ろんぐぶーつ 👢
わりざん	わりざん ➗️
うぇぶ	うぇぶ 🕸️
羽根	羽根 🪶
早送り	早送り ⏩️
じょうげん	じょうげん 🌓
骨付き肉	骨付き肉 🍖 🍗
星座（おひつじ座）	星座（おひつじ座） ♈️
画家	画家 🎨 👨‍🎨 👩‍🎨 🧑‍🎨
かーどふぁいるぼっくす	かーどふぁいるぼっくす 🗃️
ぼうぜん	ぼうぜん 😦
矢印（上）	矢印（上） ⬆️
しんがー	しんがー 👨‍🎤 👩‍🎤 🧑‍🎤
ほっとしたかお	ほっとしたかお 😌
為替	為替 💱 💹
おばけ	おばけ 👻
ぱい	ぱい 🀄️ 🥧
アスタリスク	アスタリスク ✳️ ❇️
ばちかん	ばちかん 🇻🇦
傘	傘 ☂️ ☔️ ⛱️ 🌂
LGBTQIA	LGBTQIA 🏳️‍🌈 🏳️‍🌈
よろしく	よろしく 🤝 🤝
あかいしかく	あかいしかく 🟥
あさひ	あさひ 🌄 🌅
ふぃぎゅあすけーと	ふぃぎゅあすけーと ⛸️
鉛筆とメモ	鉛筆とメモ 📝
ばにーぼーい	ばにーぼーい 👯‍♂️
むひょうじょう	むひょうじょう 😐️ 😑 😶
したぼたん	したぼたん 🔽
アンギラ	アンギラ 🇦🇮
悪口	悪口 🤬
うまい	うまい 😋 😋
溶かす	溶かす 🫕
れざー	れざー 🪒
像	像 🗿
かそう	かそう 🥸
手帳	手帳 📓
すまほ	すまほ 📱 📲 📳 📴 📶 🛜 🤳
幸せ	幸せ 🤸 🤸‍♀️ 🤸‍♂️
傷	傷 🩹
ロック	ロック 🔏 🔐 🔒️ 🔓️
こうそう	こうそう 🌿
サッカー	サッカー ⚽️
ぱぱ	ぱぱ 👨‍🍼
ぱん	ぱん 🍞 🥐 🥖 🥨 🥪 🥯 🫓
ぶー（かわいく怒）（ネコ）	ぶー（かわいく怒）（ネコ） 😾
こうそく	こうそく 🛣️
自転車に乗る男	自転車に乗る男 🚴‍♂️
お手上げする女	お手上げする女 🤷‍♀️
ひだりむきにおしているて	ひだりむきにおしているて 🫷
iマーク	iマーク ℹ️
いーゆー	いーゆー 🇪🇺
ばれーぼーる	ばれーぼーる 🏐
モルディブ	モルディブ 🇲🇻
マーシャル諸島	マーシャル諸島 🇲🇭
冠雪	冠雪 🏔️
たらーっ（汗）	たらーっ（汗） 💧
さるのかお	さるのかお 🐵
せいけつ	せいけつ 🧼
勉強	勉強 📚️
わらったあくま	わらったあくま 😈
ペット	ペット 🐇 🐈️ 🐕️ 🐩 🐰 🐱 🐶 🐹
エンブレム	エンブレム ⚜️ 🔱
ぽてと	ぽてと 🍟 🥔
コクチョウ	コクチョウ 🐦‍⬛
むおん	むおん 🔇
シャンパン	シャンパン 🍾 🥂
ジョイスティック	ジョイスティック 🕹️
ドル袋	ドル袋 💰️
農家	農家 👨‍🌾 👩‍🌾 🧑‍🌾
携帯電話	携帯電話 📱 📲 📳 📴 📶
アフリカ	アフリカ 🌍️
男性のコック	男性のコック 👨‍🍳
top	top 🔝
バーバー	バーバー 💈
ちっ（怒った顔）	ちっ（怒った顔） 😠
ぜろけいしんかんせん	ぜろけいしんかんせん 🚅
すきーやー	すきーやー ⛷️
デスクトップ	デスクトップ 🖥️
すいか	すいか 🍉
円	円 ⭕️ 💱 💴 💹
フェイスマッサージ	フェイスマッサージ 💆 💆‍♀️ 💆‍♂️
るーまにあ	るーまにあ 🇷🇴
カメラフラッシュ	カメラフラッシュ 📸
心配	心配 😟
ぱー	ぱー ✋️ 🖐️
中華	中華 🥡
すいす	すいす 🇨🇭 🫕
えきでん	えきでん 🎽
すたじおまいく	すたじおまいく 🎙️
もっこう	もっこう 🪚
すいむ	すいむ 🏊️ 🏊‍♀️ 🏊‍♂️
宅急便	宅急便 📦️
してい	してい 🈯️
サウナに入る女	サウナに入る女 🧖‍♀️
星座（へびつかい座）	星座（へびつかい座） ⛎️
爆薬	爆薬 🧨
渦巻き	渦巻き 🌀 🍥 😵‍💫
化粧水	化粧水 🧴
切符	切符 🎫
ちんもく	ちんもく 😶
きゅうぎ	きゅうぎ ⛹️ ⛹️‍♀️ ⛹️‍♂️ 🏌️ 🏌️‍♀️ 🤽 🤽‍♀️ 🤽‍♂️ 🤾 🤾‍♀️ 🤾‍♂️
冠	冠 👑 👸
してき	してき 🫵
！！	！！ ‼️
白四角中	白四角中 ◽️
賞金	賞金 💰️
閉じた錠と鍵	閉じた錠と鍵 🔐
ちぇっくまーく	ちぇっくまーく ☑️ ✅️ ✔️
きゅうす	きゅうす 🫖
びじゅつかん	びじゅつかん 🎨 🖼️
やしのきのあるしま	やしのきのあるしま 🏝️
あまぐも	あまぐも 🌧️
コンガ	コンガ 🪘
うさぎのかお	うさぎのかお 🐰
ピンク	ピンク 🩷
子供一人	子供一人 🧑‍🧑‍🧒 🧑‍🧒
びっくりしたかお	びっくりしたかお 😲
かみぱっくいんりょう	かみぱっくいんりょう 🧃
つぎのとらっく	つぎのとらっく ⏭️
さいよみこみ	さいよみこみ 🔃
きゅうゆ	きゅうゆ ⛽️
れんげざのぽーず	れんげざのぽーず 🧘
きゅうり	きゅうり 🥒
でんわのじぇすちゃー	でんわのじぇすちゃー 🤙
ばーべる	ばーべる 🏋️
じんこうそうぐ	じんこうそうぐ 🦾 🦿
刀	刀 ⚔️
Wi-Fi	Wi-Fi 🛜
！？	！？ ⁉️
ジョギング	ジョギング 🏃 🏃‍♀️ 🏃‍♀️‍➡️ 🏃‍♂️ 🏃‍♂️‍➡️ 🏃‍➡️
刃	刃 🪒 🪚
ヘラジカ	ヘラジカ 🫎
消音	消音 🔇 🔕
じゃぐりんぐするひと	じゃぐりんぐするひと 🤹
香草	香草 🌿
表情（マスク）	表情（マスク） 😷
トラクター	トラクター 🚜
女性のコック	女性のコック 👩‍🍳
まるがりーた	まるがりーた 🍋‍🟩
グアドループ	グアドループ 🇬🇵
リス	リス 🐿️
ぜむくりっぷ	ぜむくりっぷ 📎
左矢印１	左矢印１ ⬅️
ちゅうおうあふりかきょうわこく	ちゅうおうあふりかきょうわこく 🇨🇫
左矢印２	左矢印２ ↙️
せらぴー	せらぴー 💆
いてざ	いてざ ♐️ 🏹
海底	海底 🧜
にこみ	にこみ 🍲
クロスした剣	クロスした剣 ⚔️
スパゲティ	スパゲティ 🍝
病院	病院 🏥
おじぎする女	おじぎする女 🙇‍♀️
あきれがお	あきれがお 😦
白抜きのチェック	白抜きのチェック ✅️
左上	左上 ↖️
プーさん	プーさん 🍯
ぱずる	ぱずる 🧩
左下	左下 ↙️
ふぉーくらんどしょとう	ふぉーくらんどしょとう 🇫🇰
メロン	メロン 🍈
ジェット機	ジェット機 ✈️
しーくきょうと	しーくきょうと 🪯
ほにゅうるい	ほにゅうるい 🫎 🫏
じてんしゃにのるおんな	じてんしゃにのるおんな 🚴‍♀️
ぬすみみ	ぬすみみ 🫣
ライトレール	ライトレール 🚈
表紙付きノート	表紙付きノート 📔
険しい表情	険しい表情 🙎
アップル	アップル 🍎 🍏
のう	のう 🧠
ぴのきおのかお	ぴのきおのかお 🤥
モスク	モスク 🕌
れっどろぶすたー	れっどろぶすたー 🦞
指ハート	指ハート 🫰
けんじゅう	けんじゅう 🔫
つきめくりかれんだー	つきめくりかれんだー 🗓️
薄毛	薄毛 👴
さんぱつされるひと	さんぱつされるひと 💇
サーフィン	サーフィン 🏄️
剣	剣 ⚔️ 🪯
しらけた	しらけた 😒 😒
カジノ	カジノ 🎰
バニー	バニー 👯
れすりんぐするひと	れすりんぐするひと 🤼
はやさい	はやさい 🥬
のこ	のこ 🪚
りゅうきゃくるい	りゅうきゃくるい 🦕
わし	わし 🦅
懸垂式モノレール	懸垂式モノレール 🚟
しらける	しらける 😒 😒
おんがく	おんがく 🎙️ 🎚️ 🎛️ 🎤 🎧️ 🎵 🎶 🎷 🎸 🎹 🎺 🎻 🎼 📻️ 🥁 🪇 🪈 🪉 🪕 🪗 🪘
鳥類	鳥類 🐦‍⬛ 🪿
革靴	革靴 👞
割	割 🈹
冗談	冗談 😜
こどものひ	こどものひ 🎏
うまれかわり	うまれかわり 🐦‍🔥
まほうつかい	まほうつかい 🧙 🧙‍♀️ 🧙‍♂️
きのこ	きのこ 🍄 🍄 🍄‍🟫 🍄‍🟫
牡羊	牡羊 🐏
マウンテンバイクに乗る男	マウンテンバイクに乗る男 🚵‍♂️
片眼鏡	片眼鏡 🧐
わら	わら 😆
コウモリ	コウモリ 🦇
わり	わり 🈹
わな	わな 🪤 🪤
ふぁらふぇる	ふぁらふぇる 🧆
わる	わる ➗️
ベールの人	ベールの人 👰
わに	わに 🐊
ダッシュ（走り出すさま）	ダッシュ（走り出すさま） 💨
